广东斯泰克电子科技	外贸助理	深圳 龙岗区 平湖	深圳市 龙岗区 华南城2号交易广场
亿凡特生物科技	外贸专员	深圳 宝安区 沙井	深圳市 宝安区 沙井华丰高新产业园 B座2楼
易佰网络	shopee外贸运营（经验不限）	深圳 龙岗区 坂田	深圳市 龙岗区 TOD科技中心 1栋
恩可光电	外贸经理	深圳 宝安区 福永	深圳宝安区正中科技园
长科顺科技	外贸业务员	深圳	深圳龙华区观澜街道樟坑径上围村金倡达科技园k栋4楼
帝蓝科技	外贸专员	深圳 宝安区 石岩	深圳宝安区268元岭创客空间609室
深圳勤易泰科技	外贸专员	深圳	深圳市 宝安区 深圳勤易泰科技有限公司 深圳市宝安区石岩街道石龙社区工业二路6号亿源达科研园D座4楼
浩酷科技	外贸经理	深圳 龙华区 龙华	龙华街道梅龙大道194号卫东龙商务大厦A座408
艾斯芸集团ASY防伪	外贸运营	深圳 龙岗区 丹竹头	深圳龙岗区深圳市艾斯芸防伪技术开发有限公司
衡赛特电子	外贸主管	深圳 宝安区 沙井	深圳宝安区荣泰园B区11楼
MYIXI	外贸经理	深圳 宝安区 西乡	深圳市 宝安区 华盛泰科技大厦 505室
成泰昌	外贸专员	深圳 龙岗区 双龙	深圳龙岗区龙岗街道南约社区积谷田工业区1号
盛翔展示股份	外贸经理	深圳 宝安区 沙井	深圳市 宝安区 同方创意园租赁中心 2栋301-307
世纪京深科技	外贸专员	深圳 龙华区 滢水山庄	深圳市 龙华区 书香门第·上河坊(民塘路) 1栋C座608
维度数码	外贸专员	深圳 龙岗区 坂田	深圳龙岗区坂田街道，吉华路，上雪科技园1路4号C栋7楼
熠瑞康	外贸专员	深圳 宝安区 松岗	深圳宝安区恒兆工业区
用维	外贸专员	深圳 龙华区 大浪	深圳市 龙华区 裕景泰工业园2栋 2栋4楼办公室
亿凡特	外贸经理	深圳 宝安区 沙井	深圳市 宝安区 华丰高新产业园B座 2楼
彩美印刷	外贸专员	深圳 龙岗区 坂田	深圳龙岗区深圳市彩美印刷有限公司光雅园二区5号
Jagosen	外贸专员	深圳	深圳市 龙华区 星河WORLDC座 c1508号
AlphaFashion	外贸业务员	深圳 南山区 新安	深圳南山区智恒产业园11栋4楼11栋4楼
深圳飞扬体育	外贸专员	深圳 龙岗区 横岗	æ·±åœ³å¸‚é£�æ‰¬ä½“è‚²è®¾å¤‡æœ‰é™�å…¬å�¸
å¹¿ä¸œçœ�æ·±åœ³å¸‚é¾™å²—åŒºæ¨ªå²—è¡—é�“åŠ›å˜‰è·¯108å�·
励高精密	外贸经理	深圳 宝安区 沙井	深圳市 宝安区 沙井(地铁站) 福新大厦A座408（后亭地铁站）
斑点照明	外贸跟单	深圳 宝安区 西乡	深圳宝安区索佳科技创新园
云羿贸易	外贸专员	深圳 龙岗区 坂田	深圳市 龙岗区 TOD科技中心
MABVOXZ	外贸电商专员（速卖通）	深圳 宝安区 沙井	深圳宝安区运华时代A栋
帕威诺科技有限公司	外贸美工	深圳 龙岗区 横岗	深圳龙岗区启航商务大厦4A
中远达	外贸经理	深圳	深圳龙岗区德宝利工业园E栋七楼
优篮子科技有限公司	外贸业务员	深圳 龙岗区 坂田	深圳市 龙岗区 坂田国际中心 E栋412
瑞孚科技	外贸经理	深圳 龙华区 大浪	深圳龙华区恒昌荣(星辉)科技园B栋5楼
金瑞海涛	外贸跟单	深圳 宝安区 西乡	深圳宝安区深圳市宝安区固戍红湾明金海工业区a栋7号楼
虹望奈喜美	外贸经理	深圳 南山区 后海	深圳南山区海岸大厦(东座)
深圳市运作	外贸专员	深圳 龙岗区 坪山	深圳龙岗区运作电子C28栋4楼
承拓电子	外贸合伙人	深圳 坪山区 坪山	深圳坪山区圆通速递(坪山分公司)
微赛尔	外贸专员	深圳 龙岗区 布吉	深圳龙岗区百合星城C栋2409
高岭光电	外贸经理	深圳 宝安区 石岩	深圳宝安区石岩街道塘坑路57号B栋三楼
赛尔美	外贸业务员	深圳	深圳宝安区科诺大厦5-7楼
思博威激光	外贸专员	深圳 龙岗区 龙岗宝荷	深圳龙岗区方兴科技园A区1栋，5栋
FedEx联邦快递	外贸业务员	深圳 福田区 沙头	深圳市 福田区 泰然大厦A座(东北门)
燕文物流	非中邮产品助理（外贸）	深圳 宝安区 西乡	深圳市 宝安区 宝安西乡臣田工业区33栋 二楼
深圳市泰特沃贸易...	外贸助理	深圳 龙岗区 大运	深圳龙岗区金华街6-1号5/6楼
优尚佳	外贸经理	深圳 福田区 皇岗	深圳福田区福田保税区(3号门)长平商务大厦910
比蓝翻译	外贸专员	深圳 福田区 香蜜湖	深圳福田区1979文化创意园A区1栋304
通天下跨境商务	外贸业务员	深圳 龙岗区 布吉	深圳市 龙岗区 德福花园(公交站) 宝丽路63号4楼
欧诺拉光电	外贸业务经理	深圳 光明区 光明	深圳宝安区塘尾第一工业区A拣六楼
金顺印刷	阿里外贸经理	深圳 宝安区 西乡	深圳宝安区宝运达物流中心6号厂房6号厂房三楼
金豪彩色印刷	外贸助理	深圳 龙华区 观澜	深圳龙华区金倡达科技园Ｂ栋3楼
Baseus	外贸跟单	深圳 龙岗区 坂田	深圳龙岗区云里智能园3栋6楼（坂田地铁站D口200米）
瑜通实业	外贸助理	深圳 宝安区 西乡	深圳宝安区宝源华丰总部经济大厦A座1522室
海高	外贸品质工程师	深圳 南山区 前海	深圳南山区深圳市南山区前海路泛海城市广场2栋1108
智趣无限科技	外贸经理	深圳 南山区 科技园	深圳南山区留学生创业大厦
赛诺金	外贸专员	深圳 宝安区 沙井	深圳市 宝安区 全至科技创新园 2号楼5R
华冠拓展	外贸专员	深圳 龙岗区 平湖	深圳市 龙岗区 深圳市华冠拓展电子有限公司
碧云天	外贸跟单	深圳 福田区 梅林	深圳福田区通业大厦1510
乔威电源	外贸业务员	深圳 宝安区 沙井	深圳市 宝安区 深圳市安托山高科技工业园 10栋、11栋
英特可电子	外贸业务员	深圳 龙华区 龙华	深圳市 龙华区 兴龙富创客园
蓝思网络技术有限公司	产品开发/外贸电商	深圳 龙岗区 坂田	深圳龙岗区五和(地铁站)光雅园工业1区2号楼3楼bluelans
也是服装辅料	外贸经理	深圳 龙岗区 坪地	深圳龙岗区深圳市也是服装辅料有限公司1栋1楼
耐思摄影器材	外贸业务员	深圳 龙岗区 平湖	深圳龙岗区深圳市耐思摄影器材有限公司(凤凰大道)凤凰大道15号
欣天雅包装	外贸业务员	深圳 龙岗区 平湖	--==--==--
LOVE VAPE	外贸合伙人	深圳 宝安区 沙井	--==--==--
潘朵科技	亚马逊外贸专员	深圳 宝安区 新安	--==--==--
联创科技集团	外贸业务员	深圳 龙岗区 布吉	--==--==--
深圳彩诺科技	外贸业务员	深圳 龙岗区 布吉	--==--==--
天眼新能源	外贸经理	深圳 宝安区 西乡	--==--==--
亚声威格科技	英语外贸	深圳 龙岗区 坂田	--==--==--
贝贝乐	外贸主管	深圳 龙岗区 双龙	--==--==--
钰创合成光电	外贸助理（英语）	深圳 宝安区 新安	--==--==--
国健华烟	外贸经理	深圳 南山区 蛇口	--==--==--
原道	外贸经理	深圳 宝安区 福永	--==--==--
飞猫电器	外贸业务	深圳 宝安区 沙井	--==--==--
