深圳市曼克科技有限公司	外贸业务员  急
深圳市优可新科技有限公司	外贸业务员/外贸销售（轻松月薪过万）
深圳蓝尚饰品有限公司	亚马逊运营助理
深圳市路径科技有限公司	外贸跟单员
深圳市辉拓电子有限公司	外贸业务  亚马逊运营  速卖通专员
深圳市德科泰电子有限公司	外贸业务员
深圳市世捷国际货运代理有限公司	外贸货代业务 国际货代（底薪+提成）
深圳中陇天包装科技有限公司	外贸跟单（西乡坪洲C出口附近）
深圳天俊镭射科技有限公司	外贸业务员
深圳市云数字科技有限公司	外贸 ebay销售 运营（高提成）
广东佳的美智能科技有限公司	外贸业务员
深圳市华普微电子有限公司	外贸跟单
深圳市时刻美科技有限公司	外贸客服
骏麟（深圳）贸易有限公司	五天双休社保+外贸业务助理
深圳市仁信自动化设备有限公司	高薪诚聘 外贸业务员
深圳市绘王动漫科技有限公司	外贸物流专员 / 助理 / 物流文员
深圳市瀚思通汽车电子有限公司	外贸/贸易专员/助理
深圳市富威盛电子有限公司	外贸业务员―(安防产品)
恒界时代科技（深圳）有限公司	外贸业务员（高薪）
优译有限公司	外贸经理/外贸主管
深圳市强易盛贸易有限公司	外贸销售助理
深圳市优威埃科技有限公司	外贸业务员
深圳市领拓创新电子有限公司	外贸主管/经理/智能家居
深圳市都伟力塑胶电子有限公司	（高薪急聘）外贸开发业务/专员
深圳市圳兴模具有限公司	外贸业务员
深圳市优桥科技有限公司	外贸跟单员--高薪急聘
深圳市汇一邦科技有限公司	外贸业务助理/应届生
深圳市成为信息技术有限公司	外贸商务助理
深圳市艾美莉化妆用品有限公司	外贸业务员
深圳市精正照明有限公司	外贸业务员
深圳市鑫洁雅清洁品有限公司	亚马逊销售 外贸销售 电商运营员
深圳市雅诗卡洛科技有限公司	外贸跟单员
深圳市百纳精通科技有限公司	海外销售部经理/外贸经理
珠海科域生物工程股份有限公司	外贸专员（医疗体外诊断设备）
深圳市莱可照明科技有限公司	外贸业务主管
深圳市创优世界电子商务有限公司	B2C外贸业务员 五险一金+高提成
深圳市同创新佳科技有限公司	外贸产品经理
深圳市元创意科技有限公司	外贸业务员 （日语）
深圳市优贝特科技有限公司	急聘 外贸跟单员
深圳市松发祥纸品有限公司	外贸业务员（底薪5000以上+提成+奖金）
鑫锋辉科技（深圳）有限公司	外贸销售专员
深圳丽鸿光电有限公司	诚聘外贸业务员（宝安石岩/周末双休）
FreeTek International Co.,Ltd.	外贸业务员 (业绩提成+利润提成)
深圳市小尔美科技有限公司	速卖通业务、B2C外贸业务员
百博金属材料（深圳）有限公司	外贸跟单员
深圳市领先康体实业有限公司	俄语外贸销售
深圳市盛达凯手袋服装有限公司	外贸业务助理
深圳市德柯电子商务有限公司	外贸仓库打包员
深圳市汇达发科技有限公司	外贸业务员
深圳市杰美克安防科技有限公司	外贸业务员
深圳市华凌安科技有限公司	外贸业务员（广东阿姨做饭）/（包住）
深圳市艾佳贸易有限公司	诚聘外贸业务/亚马逊销售（应届生优先)
深圳市杰信特科技有限公司	外贸业务员（ 周末双休）
深圳市鼎鑫伟业科技有限公司	外贸跟单助理
深圳市益加时尚科技有限公司	外贸销售工程师
深圳市骜途智能科技有限公司	外贸跟单员
深圳市艾思迈科技有限公司	日语外贸
深圳市深工新能源有限公司	外贸业务员
深圳市易生活健康电子有限公司	外贸业务/速卖通销售(高提成)
深圳市沃莓科技有限公司	外贸专员 外贸业务员 电商运营 高薪住宿 五险一金
深圳市富明威实业有限公司	外贸业务员/阿里巴巴国际站
源德盛塑胶电子（深圳）有限公司	外贸业务员
深圳市艾比利数码有限公司	alibaba国际站业务员/外贸跟单
深圳市畅达能科技有限公司	外贸助理   外贸业务    外贸专员
深圳市鹏龙利盛建材有限公司	外贸业务员
深圳市弗洛米科技有限公司	外贸助理--包吃包住
深圳市金斯达工贸有限公司	日语销售 日语外贸业务 日语翻译
深圳市完美显示科技有限公司	外贸专员
深圳市邦彦电子科技有限公司	PCB/PCBA/SMT外贸业务员
深圳市宝利源手袋皮具厂	外贸业务员（底薪+高提成+奖金）
深圳市劲麦商贸有限公司	Amazon外贸业务员（地铁口）
深圳市明为伟业科技有限公司	外贸业务员/外贸专员
深圳市艾鹏网络科技有限公司	外贸业务
深圳市圣亚国际物流有限公司	外贸专员（日语)
深圳市爱奇丽科技有限公司	外贸业务员/外贸助理
深圳市玛莱娜化妆用具厂	外贸
深圳十镁科技有限公司	外贸业务员/专员/客服
深圳市品智好科技有限公司	外贸销售/外贸专员
深圳市安鑫五金塑胶有限公司	外贸业务员
深圳市三号水产配送有限公司	国外采购/外贸专员
深圳市关键信息技术有限公司	外贸销售
深圳市经纬华天科技有限公司	外贸业务员（包吃包住）
深圳市群新电子有限公司	外贸业务员
深圳市追梦网络科技有限公司	外贸主管
昭星实业（深圳）有限公司	外贸跟单员   高级业务跟单
深圳兴先达五金塑胶制品有限公司	外贸跟单员
深圳市聚创意创新科技有限公司	外贸业务助理
深圳市新美威科技有限公司	阿里巴巴国际站运营/外贸业务员
深圳市华辰联创科技有限公司	外贸销售 外贸销售员  海外市场拓展
深圳市好的之光科技有限公司	外贸业务员
深圳市新涛控股有限公司	外贸业务员
深圳鸿硕达科技有限公司	外贸业务员(提成五个点，双休)
深圳恒诚伟业科技有限公司	外贸业务员
深圳珉丰集装箱服务有限公司	外贸储备干部（英语或马来语）
广东沃得光电科技有限公司	外贸主管或外贸经理
深圳市德康家居用品有限公司	外贸销售/国外参展机会
深圳市嘉威宝家庭用品有限公司	外贸/贸易经理
深圳市熙龙玩具有限公司	日语外贸经理
深圳市华富洋供应链有限公司	外贸专员/跟单员
深圳市赢鸿科技有限公司	外贸专员
深圳市深海诺科技有限公司	外贸客服（科技公司代招）
深圳市唯其善电子有限公司	外贸助理/外贸专员/销售
深圳市妮奥电子有限公司	速卖通外贸运营助理
深圳市华雅纳电声有限公司	外贸业务员
深圳市博亚星电子技术有限公司	外贸推广员
深圳市英霏特科技有限公司	电子烟外贸业务员（宝安+地铁沿线+高提成）
深圳市奥斯珂科技有限公司	外贸业务5K-10K
深圳美声包装印刷有限公司	外贸跟单员（周末双休）
深圳市斑斓实业有限公司	外贸业务员
深圳市恩科电子有限公司	外贸经理助理
划时零距电子（深圳）有限公司	外贸业务员（周末双休）
深圳欧�N科电子有限公司	外贸助理
深圳市江森企业管理咨询有限公司	日语外贸业务员
深圳市联创杰科技有限公司	电子元器件（IC）外贸销售助理
深圳市帝欧贸易有限公司	陶瓷外贸/业务员/外贸/贸易专员
深圳卡尔士贸易有限公司	亚马逊运营/外贸
深圳市瑞思祥科技有限公司	外贸业务员
深圳市传盛科技有限公司	外贸业务员 速卖通销售 跨境电商销售 晋升快
深圳市易普乐化工有限公司	外贸业务员（英语）
粤和兴激光刀模（深圳）有限公司	外贸专员（英语）
深圳市帆叶风科技有限公司	提供住宿 外贸销售代表  跨境电商专员 B2C外贸业务员
深圳市天祥纸业有限公司	外贸跟单员
深圳市达伯文科技有限公司	外贸网站推广运营专员
深圳华创兆业科技股份有限公司	外贸助理
深圳市米高电子科技有限公司	带薪培训  外贸销售   亚马逊运营
深圳市辉宏科技有限公司	外贸业务员五险一金5.5天5K+
深圳市欣天雅包装有限公司	外贸助理
深圳市威孚恒创科技有限公司	诚聘高级外贸跟单员（高薪+周末双休）
深圳市巨拓科技有限公司	Amazon销售/亚马逊销售/外贸业务员
深圳伊西威威网络科技股份有限公司...	外贸主管
深圳市明润达贸易有限公司	外贸助理（速卖通ebay）高底薪欢迎优秀毕业生
深圳市青长物产商贸有限公司	外贸业务助理---泰语
深圳市鑫冠森科技有限公司	跨境电商 运营 外贸销售
深圳市利辉快速成型技术有限公司	外贸业务员 高提成新兴产业
深圳市百炼五金有限公司	外贸业务员 可接受应届毕业生
深圳市艾普生物科技有限公司	外贸业务员
深圳瑞万昌实业有限公司	外贸业务员(喜欢挑战)
深圳市依波特科技有限公司	外贸销售
深圳市英特飞电子有限公司	外贸业务员（应届毕业生亦可）
深圳市联泽科技有限公司	外贸业务员/外贸销售/外贸专员
深圳市高飞贸易有限公司	速卖通客服/外贸客服/英文客服（五和地铁口）
深圳市瑞鼎电子有限公司	外贸业务员
深圳市广宇视通科技有限公司	外贸业务员  急聘  (可接受应届毕业生)
深圳市同兴包装有限公司	外贸业务员
深圳市优宜得电子商务有限公司	高薪诚聘 年轻团队 跨境电商运营 外贸运营 外贸助理
深圳斯罗克电子有限公司	外贸专员 跨境电商运营+提供住宿
深圳市高森家居用品有限公司	五险一金聘请高级外贸跟单员
深圳嘉程世纪贸易有限公司	外贸销售助理
阳盟科技股份有限公司	外贸助理- 英语口语流利
深圳市方德建材有限公司	外贸销售
深圳市维盛泰光电有限公司	外贸业务员
深圳市华冠光电科技有限公司	外贸/贸易专员/助理
深圳常瑞实业有限公司	外贸助理/外贸专员
香港星权有限公司深圳代表处	外贸采购跟单
深圳市协同国际物流有限公司	外贸业务/专员（双休）
稳健医疗用品股份有限公司	高级外贸业务员（外销员）
深圳市诚丰浩电子有限公司	外贸跟单员(提供住宿）
深圳市美高蓝电子仪器有限公司	外贸跟单员
深圳文华纺织品时装有限公司	外贸跟单（高薪聘请）
深圳市石开科技有限公司	业务员 外贸业务员
深圳市恒之电子商务有限公司	外贸业务员(英语)
中国恒跃实业有限公司	外贸业务员 （双休+发展空间大+提成）
深圳市盛邦科技有限公司	Amazon亚马逊销售/外贸销售/亚马逊业务/B2C
深圳市华万达电子有限公司	外贸业务员、外贸专员(可接受应届毕业生)
深圳市键特电子有限公司	外贸区域经理
深圳市清山泉环保科技有限公司	外贸跟单员
深圳市记忆时候科技有限公司	B2B外贸业务员
深圳市多奇想电子有限公司	外贸/亚马逊助理/高提成
深圳市火速国际物流有限公司	外贸业务（住宿+津贴）
深圳建准电机有限公司	外贸业务员（包吃住+高提成+五险一金）
深圳市浩骏包装制品有限公司	外贸业务员（包吃住+高薪+高提成）
深圳科赢思贸易有限公司	外贸跟单员
深圳福德源智能科技有限公司	外贸跟单助理
深圳兴豪皮具有限公司	外贸专员+双休+包公寓住宿包吃
深圳市星益电子商务有限公司	B2C外贸运营 电子商务专员 接受转行 提供住宿
深圳市鑫联众达电子有限公司	外贸业务员
深圳市双向诚科技有限公司	外贸业务
深圳市易顺科技有限公司	外贸主管
深圳科腾智能显示技术有限公司	外贸业务员
深圳市荣拓电子商务有限公司	外贸销售
深圳市进和瑞电子有限公司	外贸业务员
深圳市新贸国际货运代理有限公司	外贸文员
深圳市杨翔文化传媒有限公司	外贸主管
深圳市艾泽瑞光电有限公司	急招外贸采购员
深圳市新良田科技股份有限公司	外贸运营专员
深圳市利得尔展示用品有限公司	外贸业务员
深圳市真华电子科技有限公司	Amazon 亚马逊 外贸 销售 专员
深圳市嘉音美电子有限公司	外贸业务员
瑞丰手袋（深圳）有限公司	外贸业务员
深圳市博恩医疗器材有限公司	外贸业务经理/外贸业务员
深圳长荣家居用品有限公司	外贸业务员
深圳大霞创意文化有限公司	高薪诚聘 外贸业务员/外贸销售员（出国参展+高提成）
深圳市金沃琪科技有限公司	外贸销售助理
深圳市思普泰克科技有限公司	外贸跟单员
深圳市德嘉医疗器械有限公司	外贸业务员（B2B平台/网络推广）
深圳市程达科技有限公司	外贸业务员
深圳市大仁科技有限公司	急聘外贸业务员（阿里巴巴）
深圳彩诺科技有限公司	外贸业务员
深圳市大阳实业发展有限公司	外贸业务员/消费类电子
森骏卓越精密模具（深圳）有限公司...	外贸销售工程师
深圳市百合隆工艺制品有限公司	外贸业务员/销售 坪山新区上班
深圳虹辉实业有限公司	外贸业务员
深圳起之秀国际贸易有限公司	外贸业务员
深圳市兴佳维诚电子有限公司	外贸跟单员
深圳市百马汇咨询服务有限公司	外贸助理
深圳市深贸发陶瓷有限公司	外贸跟单员
广东奥博特实业有限公司	外贸业务员
深圳市蓝图科创科技有限公司	外贸业务员
深圳宝联贸易有限公司	船务文员/物流专员/外贸跟单
深圳市龙之杰电子有限公司	外贸专员
深圳市爱德泰科技有限公司	外贸业务员
深圳市中德利科技有限公司	外贸业务员 （双休+包住）
深圳市奇洛普科技有限公司	外贸业务员
深圳市深蓝鼠飚科技有限公司	外贸助理
深圳市盛仕达电子有限公司	外贸专员
深圳市宇拓科技有限公司	产品编辑外贸销售助理
华强眼镜（深圳）有限公司	外贸业务员/外贸跟单（急聘）
深圳市朗韵乐器有限公司	外贸业务助理
深圳市宜视安科技有限公司	B2B外贸业务员（氛围好+提成高+海外参展机会）
深圳市熙锐网络科技有限公司	西语、法语、德语、英语、意大利语外贸销售员
深圳市金�A贵材科技有限公司	外贸跟单主管
深圳市凌吟科技有限公司	亚马逊外贸专员
深圳市川特电子科技有限公司	外贸业务
深圳市力容电子有限公司	外贸助理/专员
深圳市泽维尔精密组件有限公司	外贸业务 急聘（包吃住）
深圳市麦蜂科技有限公司	外贸业务员（急聘+高薪）
深圳市铭正阳电子有限公司	外贸专员
深圳市嘉伟亿科技有限公司	韩语销售（外贸专员、韩国市场销售）
合联国际企业有限公司	外贸跟单员
湘林电子（香港）有限公司	外贸业务员
深圳市特和实业有限公司	B2B外贸业务员（双休+入职买社保）
深圳市盛世盟科技发展有限公司	外贸业务员-清湖地铁站附近
深圳泛亚运通国际货运代理有限公司...	外贸业务员
深圳市兴锦轩进出口有限公司	外贸业务员
深圳市粹联科技开发有限公司	外贸业务员
深圳市裕福华手袋制品有限公司	外贸B2B销售
深圳梦达国际商贸有限公司	亚马逊外贸业务员+无责任底薪高提成+应届生可接受
深圳市亿配电子商务有限公司	wish运营/wish销售/外贸运营/外贸销售
深圳飞音时代网络通讯技术有限公司...	外贸业务员（网络通讯设备，五险一金+国外参展机会）
深圳市皓华网络科技有限公司	亚马逊销售/外贸业务员
深圳市昂威手袋有限公司	亚马逊销售 /外贸销售员 （英语、日语、德语）
深圳市雷明电子有限公司	外贸业务员/外贸销售（高薪）
深圳市禧伽贸易有限公司	外贸单证员
鸿福泰电子科技（深圳）有限公司	外贸跟单员
深圳市易霸科技有限公司	外贸业务员
深圳市美诺电子商务有限公司	国际贸易专员/国际业务员
深圳市达博六号供应链管理有限公司...	销售精英（进口服务方向）
深圳市玖福电子商务有限公司	亚马逊运营（日语）
深圳市沃恩德溢光电科技有限公司	阿里巴巴国际站运营
深圳市颉沃创新科技有限公司	亚马逊管培生/储备/英语/日语/德语
万博时代（深圳）科技有限公司	亚马逊客服经理
深圳市杰瑟普商贸有限公司	Shoppe销售
深圳市海吉星冷链股份有限公司	审单专员
深圳市概念智慧科技有限公司	外贸业务员/外贸销售/国际贸易/国际销售/阿里巴巴运营
深圳市捷泰技术有限公司	资深亚马逊销售  amazon运营
深圳市政元软件有限公司	销售业务员
深圳雷炎科技有限公司	海外区域销售经理
深圳市东华计量检测技术有限公司	电话销售
深圳爱世奇服饰有限公司	行政前台文员急招
深圳市智傲商贸有限公司	亚马逊销售（福利好+周末双休）
深圳市光中道电子有限公司	急聘外贸业务员/海外销售/国际业务员/海外销售工程师
深圳泽谷网络科技有限公司	Amazon亚马逊运营销售/精品（民治地铁）
深圳市百为视讯电子有限公司	海外销售工程师
深圳市欣视景科技股份有限公司	商务专员 英语
深圳市聚友电子商务有限公司	法语网站编辑推广
深圳市腾凯电子商务有限公司	Ebay销售
深圳市翠特科技有限公司	亚马逊日语销售
无锡睿米信息技术有限公司	海外销售经理(深圳）
深圳市泰普森科技有限公司	业务专员
深圳市易拓时代科技有限公司	wish销售主管/运营主管
四星（深圳）贸易有限公司	产品开发 PD Specialist
深圳市富皇美运国际商贸物流有限公...	货代海外销售
深圳侨云科技股份有限公司	应届生
深圳市卓禾仪器有限公司	研发部经理
深圳市沃菲德户外用品有限公司	总经理秘书/助理
深圳市乐其网络科技有限公司	亚马逊运营助理（精品 应届生）
深圳乐行天下科技有限公司	海外客服
深圳市迅光智能科技有限公司	facebook运营推广
深圳市科奈信科技有限公司	销售助理――KAD
深圳市易尚光伏科技有限公司	ebay运营主管 ebay销售主管
深圳市欧提克电子科技有限公司	亚马逊CPC广告投放员（包中餐）
深圳市蜘蛛百讯科技有限公司	海外推广/SNS运营
深圳市亿科杰科技有限公司	运营专员
深圳诺彩实业有限公司	网络推广专员
深圳市天龙世纪科技发展有限公司	海外销售经理
深圳市玺丰睿科技有限公司	跟单员（双休）
深圳市易科森科技发展有限公司	亚马逊Amazon英文销售
深圳市影成科技有限公司	AMAZON推广专员
深圳四维高科技术有限公司	wish运营主管
深圳市海丰国际进出口有限公司	阿里国际站产品开发、爆款开发(饰品)
深圳市库贝尔生物科技股份有限公司...	外贸业务员/外贸专员/国际销售代表/国际销售专员
深圳市兆驰股份有限公司	TV-海外销售
深圳市韦普柯科技有限公司	韩语业务员（双休）
深圳市火技家居有限公司	Ebay运营
海纳百佳国际货运（深圳）有限公司...	国际物流业务员
深圳市君伟胜科技有限公司	电商平台业务员
深圳市东特塑胶制品有限公司	业务代表
深圳市欧恩半导体照明有限公司	SEO推广专员
深圳丰汇汽车电子有限公司	亚马逊销售
深圳市安达顺国际物流有限公司	空运客服经理
深圳市致远科技有限公司	阿里国际站运营（高薪+提供食宿）
深圳市创鑫海工艺品有限公司	日语业务员
旭日牙科器材（深圳）有限公司	英语翻译文员（应届毕业生）
深圳思科英达科技有限公司	亚马逊日本站运营
深圳市迈煌电子科技有限公司	英语客服
广州市驭邦贸易有限公司	西班牙语销售
深圳华众拓国际供应链有限公司	亚马逊运营助理
鑫荣懋集团股份有限公司	进口商务专员
卡登（深圳）电子商务有限公司	lazada运营专员
深圳市商瑞康光通迅有限公司	人事主管
深圳市港盛投资顾问有限公司	咨询顾问
深圳市百事特体育用品有限公司	业务主管
深圳市立刻飞技术有限公司	亚马逊运营专员
深圳市泛客思科技有限公司	坂田亚马逊英语销售
深圳智汇创想科技有限责任公司创客...	亚马逊美国站销售（精品）
深圳市康仁顺贸易有限公司	Wish平台运营 wish销售 销售专员
深圳聚优良品电子商务有限公司	亚马逊推广专员
深圳市宝视佳科技有限公司	带薪培训  速卖通运营/亚马逊运营/ 跨境电商运营
深圳市蓝禾照明有限公司	人事行政文员
深圳多思考电子商务有限公司	管培生（亚马逊运营）
深圳市理诚科技有限公司	电子类品检员/质检员/QC/QA/验货员
深圳悦创意文化产业有限公司	电商采购开发
深圳市斯派克光电科技有限公司	英文推广
深圳市联佑光电技术有限公司	业务实习生
深圳市普瑞鑫科技有限公司	亚马逊主管
深圳市天中天贸易有限公司	eBay平台业务员/eBay运营专员
深圳在岸港商务有限公司	市场推广
深圳市昭阳天下科技有限公司	亚马逊销售/日语/底薪6K+
深圳市中芯供应链有限公司	商务助理
深圳市中远达智能科技有限公司	阿里巴巴国际站运营
深圳市扬泽科技有限公司	跨境电商助理
深圳市麦购创新科技有限公司	采购经理
深圳市科比顿科技有限公司	Lazada运营
深圳奇尼思尔电子商务有限公司	（急聘）亚马逊销售助理/精品/应届生
深圳市易兴泰科技有限公司	海外业务员
深圳市迈高生物科技有限公司	单证员
深圳市瀚�N宇电子商务有限公司	供应商开发
深圳谱程未来科技有限公司	跨境电商产品开发（精品）
深圳市金流明光电技术有限公司	应届毕业生(双休)
深圳市晨凡电子商务有限公司	丹竹头地铁站B出口 销售 亚马逊
深圳市世纪瀛通科技有限公司	业务员 / 贸易销售 网络销售
深圳市奥睿拓科技有限公司	法语/意大利语  亚马逊运营（4k-12k）
广西怡凯家居用品有限公司	亚马逊运营专员
深圳市创新奇通讯有限公司	亚马逊运营主管
深圳市光网视科技有限公司	海外推广
深圳市微克科技有限公司	wish销售
深圳市福瑞斯礼品有限公司	销售代表（高薪+高提成）
深圳市信诚网络技术有限公司	wish销售/wish运营
深圳市蓝之海供应链管理有限公司	采购专员 采购员 五险一金
深圳盖亚拓扑网络技术有限公司	亚马逊运营助理
北京春水堂商业连锁有限公司	国外友人亚马逊运营
深圳百英汇科技有限公司	亚马逊销售
广州广策良成数码科技有限公司	Amazon亚马逊运营专员
深圳市顺光德科技有限公司	亚马逊运营专员
深圳市宝华中科技有限公司	亚马逊/速卖通物流专员
深圳市恒迅佳科技有限公司	仓库打包员
深圳市赛辉电子有限公司	运营专员
深圳市优米未科技有限公司	亚马逊精品开发
深圳市前沿智造科技有限公司	诚聘资深亚马逊运营专员（宝安区）
深圳天亿诚品科技有限公司	速卖通运营助理
深圳市丰润达科技有限公司	大区经理/北美/North America
深圳市景铄贸易有限公司	日语销售助理
深圳市鼎隆辉科技有限公司	采购
深圳市格乐德科技有限公司	速卖通运营/销售专员
深圳市戍百尔科技有限公司	财务/会计
深圳市爱遥控科技有限公司	亚马逊开发
深圳市路特电子商务有限公司	美国站销售（双休/高提成/地铁口附近）
深圳市垦鑫达通讯设备有限公司	海外销售
深圳市伟跃科技有限公司	Amazon亚马逊女装产品开发
深圳市奇辉石英电热制品有限公司	电商运营
深圳市普润天华企业管理有限公司	电商销售
深圳市诺顺达货运代理有限公司	业务跟单助理
深圳市网视无忧科技有限公司	产品开发（LED）
深圳市富德康电子有限公司	B2C运营业务员
深圳市澳伦堡科技有限公司	亚马逊销售/业务（西乡）（急聘）
深圳市喜德盛自行车股份有限公司	项目工程师
深圳市富智祥电子有限公司	销售助理
深圳市赛诺金动力科技有限公司	英语业务员
深圳市海力工业设备有限公司	商务采购/采购员/采购专员
深圳海云舟科技有限公司	Amazon亚马逊日本销售/亚马逊日本运营
深圳前海马茨科技有限公司	产品经理
深圳市米洛电气有限公司	网站运营主管（东莞）
深圳市万斯凯网络科技有限公司	亚马逊美国销售/运营
深圳市天创伟业科技有限公司	跟单员/跟单文员（轻松文职岗）
深圳市秀顺不干胶制品有限公司	跟单文员年薪5-15万
深圳麦维普斯电子科技有限公司	Ebay销售主管
深圳市麦极科技有限公司	亚马逊日语业务
深圳市艺科电子有限公司	日语业务员
泰钢合金（深圳）有限公司	日语跟单
深圳市威斯达照明有限公司	日语业务员
深圳市奥美迪贸易发展有限公司	外销客户经理
深圳市世纪环海贸易有限公司	船舶经纪
深圳非凡模型科技有限公司	阿里巴巴国际站业务员
深圳市迈普视通科技有限公司	西班牙语销售
深圳市羽西网络科技有限公司	亚马逊销售
深圳市亮彩科技有限公司	应届毕业生
深圳市睿德恒通贸易有限公司	速卖通运营主管  银牌店铺
深圳市恒力芯源电子科技有限公司	法语亚马逊销售
深圳美林联合国际货运代理有限公司...	俄语市场开发专员
广州聚焦网络技术有限公司深圳第二...	销售代表
广州市安创集运供应链有限公司	英语客服（5k-8k)
深圳市奥斯拓科技有限公司	急聘亚马逊运营销售美国站
深圳市巨能光电有限公司	产品开发
深圳俊恩包装制品有限公司	财务助理
深圳市西啡科技有限公司	高级业务跟单
深圳市中葛科技有限公司	优秀应届毕业生
深圳市爱培科技术股份有限公司	海外业务经理
深圳市神州行户外用品有限公司	速卖通运营
深圳傲威科技有限公司	日语销售/外贸业务员/Amazon日语销售/外贸电商运营
深圳市易道海纳科技有限公司	shopee销售/运营
深圳市天裕鑫科技有限公司	亚马逊销售/销售主管
深圳市源恒泰科技有限公司	运营专员
深圳市人和口腔技术有限公司	应届毕业生
深圳市杰仕博科技有限公司	英文跟单
深圳市卡斯时代贸易有限公司	速卖通客服 店长助理
深圳市中港大药房有限公司	亚马逊销售
深圳市正义网络技术有限公司	海外运营
金手指创新科技（深圳）有限公司	销售代表
方圆天下（深圳）科技有限公司	业务跟单/在线客服/在线销售
深圳市中冠智能电子科技有限公司	销售代表
广东吉荣空调有限公司	吉荣空调深圳分公司销售精英
环球资源（华南区）	销售代表（深圳总部）
深圳市嘉联兴科技有限公司	平面设计师
深圳市展名科技有限公司	亚马逊专员
深圳市鑫卡立方智能科技有限公司	采购主管
深圳天基权健康科技集团股份有限公...	海外市场专员
深圳市纳音科技有限公司	产品经理
深圳市立洋光电子股份有限公司	销售工程师-(海外)
彩迅工业（深圳）有限公司	电商运营专员
深圳市康冠技术有限公司	外销业务员（TV）
深圳裕兴诚科技有限公司	亚马逊产品经理
深圳市维希特科技有限公司	业务人员
深圳市卡兰士贸易有限公司	亚马逊运营/亚马逊运营专员/五险一金/5K+
深圳市意向互动科技有限公司	亚马逊销售主管
深圳市俱进纸品包装有限公司	平面包装设计师
深圳市铭华航电工艺技术有限公司	销售代表
深圳市泰世科技有限公司	美工
深圳市中工巨能科技有限公司	销售代表
深圳市强流明光电有限公司	海外销售
深圳市顺信达贸易有限公司	Joom运营专员
深圳市金五星电子有限公司	亚马逊销售运营
深圳市友基技术有限公司	海外仓储物流员
达邦制衣设计（深圳）有限公司	跟单助理
深圳市源锋兴业科技有限公司	急聘财务助理包吃包住
深圳市众创腾达科技有限公司	急聘敦煌/速卖通/业务/销售
深圳市光科照明有限公司	LED日语业务员
深圳市奥睿电子商务有限公司	产品开发专员
深圳市瑞隆源电子有限公司	亚马逊运营专员
深圳市蓝盾环保科技有限公司	阿里巴巴国际站运营
百令信息科技（上海）有限公司	供应商开发主管
金进科技（深圳）有限公司	英语翻译
富士康科技集团CNSBG事业群	物料专员
深圳市量能科技有限公司	外销跟单
深圳市金洋电子股份有限公司	高级业务跟单
深圳市诚丰乐琪科技有限公司	亚马逊运营专员
深圳市伟龙鑫工艺礼品有限公司	亚马逊销售（龙城广场地铁站C出口）
深圳市时创意电子有限公司	国内业务员
力顿钮扣配件（深圳）有限公司	市场开发专员
深圳市兴龙辉科技有限公司	亚马逊欧洲站运营
深圳市瑞德丰精密制造有限公司	业务跟单
深圳市源格林科技有限公司	会计专员（成本）
方博科技（深圳）有限公司	电子料采购
翔耀电子（深圳）有限公司	项目管理师
广东思格雷电子科技股份有限公司	市场推广专员（海外）
深圳市联创科技集团有限公司	储备干部--优才计划
深圳市鼎好纸制品包装有限公司	阿里巴巴国际站运营
东方电子科技（国际）有限公司	英语业务员
河南科隆新能源股份有限公司	文员助理
阿里巴巴集团	国际事业部-资深客户经理-宝安
深圳市中京科林环保塑料技术有限公...	英语翻译
深圳市双月科技有限公司	速卖通运营组长/主管/销售专员
杰伟尼技术（深圳）有限公司	海外销售（稳定底薪+高提成）
元田科技（深圳）有限公司	8K亚马逊运营--英语
深圳市慧明眼镜有限公司	应届毕业生
深圳斯达领科网络科技有限公司	跨境电商产品开发（服装）
深圳市龙成伟业科技有限公司	亚马逊运营  高提成+双休+五险+补贴
深圳市志康科技有限公司	人力资源专员/人事主管
深圳市风云电池有限公司	业务跟单
深圳市瑞科恩科技有限公司	海外推广总监
深圳市际客电子商务有限公司	英语管培生（接受应届生）
深圳市乐骑智能科技有限公司	(双休）亚马逊客服专员
深圳细刻网络科技有限公司	运营助理
深圳市深陆贸易有限公司	英语客服
深圳建兴实业有限公司	亚马逊推广/品牌推广/网络推广
深圳市亿莱电子商务有限公司	产品编辑 电商产品编辑 英语编辑
深圳市德仁光电科技有限公司	船务专员
深圳市创佳兴礼品有限公司	亚马逊销售/速卖通/ebay销售（底薪+提成+急聘）
深圳市龙达腾飞科技有限公司	网络客服销售
德瑞兴（深圳）咨询有限公司	Merchandiser
深圳市未来基石管理咨询有限公司	高级销售专员（双休+急聘）
中控智慧科技股份有限公司	海外推广优化师
深圳中电投资股份有限公司	PHP开发工程师
深圳市比斯拓科技有限公司	仓库主管
深圳市莆晶电子科技有限公司	亚马逊运营专员/助理
深圳佳友国际货运代理有限公司	货运代理销售代表/物流顾问
深圳市乔威电源有限公司	海外品牌业务员
深圳市乔安科技有限公司	Amazon运营主管/地铁口/包住
深圳市艺帆电子商务有限公司	速卖通Aliexpress业务员客服
深圳市博迪科技开发有限公司	品牌总监
深圳市豪瑞祥科技有限公司	日语SEO推广/网站运营
深圳爵瑞实业有限公司	亚马逊销售主管
深圳市亚鹏联合货运代理有限公司	销售运营助理
深圳市爱奇迹科技有限公司	产品经理（产品中心）
辰马实业（深圳）有限公司	包装印刷报价员/预算员（高薪诚聘）
深圳市红阳光能源技术有限公司	亚马逊amazon美国站运营/销售  包住
深圳市仁义和兴塑胶五金制品有限公...	亚马逊销售
深圳市裂变者科技有限公司	美国站运营 亚马逊运营
深圳德普瑞工控工程有限公司	诚聘德语商务
深圳市海丽欣印刷有限公司	国内贸易员
深圳市鼎铭科技有限公司	应届生 亚马逊运营助理（底薪+提成+年终奖）
深圳市清振拓电子科技有限公司	电商产品专员
深圳市九九网络企业	Amazon亚马逊销售 跨境电商销售
深圳��奔能欧迪科技有限公司	跨境电商平台销售/英文销售
深圳扬俊科技有限公司	国际贸易员
深圳汉尼康科技有限公司	海外客户经理
深圳市视壮科技有限公司	跨境电商销售
深圳市协创达国际货运代理有限公司...	国际货代操作
深圳丰润信息科技有限公司	速卖通主管
深圳市位杰科技有限公司	海外业务员
深圳灿新科技有限公司	阿里巴巴国际站运营
深圳市润添贸易有限公司	业务助理
深圳市泽闻科技有限公司	亚马逊美国站销售
深圳市阿德赛商贸有限公司	亚马逊助理（日语+英语）
香港欣达实业股份有限公司	诚聘亚马逊运营 六约主管地铁口
倬永科技（深圳）有限公司	韩语营业担当
深圳市赛尔瑞科技有限公司	国际销售代表
深圳市志纵四海科技有限公司	lazada运营专员/lazada销售
嘉里大通物流（深圳）有限公司	海运操作
深圳市诺希德贸易有限公司	德语采购
深圳市安盛翼电子商务有限公司	亚马逊英语运营助理
誉标检测(深圳)有限公司	海外推广经理
深圳市新赢威尔电子有限公司	电子烟业务员
踏浪者国际有限公司	Ebay客服
深圳市丹宇电子有限公司	线路板采购员
深圳市千翔泰科技有限公司	电商专员
北京斯雷康科技股份有限公司	亚马逊运营专员(德语)
深圳市小樱桃实业有限公司	售后客服
深圳市爱伊彩科技有限公司	亚马逊运营 AMAZON销售专员 龙岗中心城
深圳市捷德供应链管理有限公司	销售代表
深圳市金康瑞科技有限公司	阿里巴巴国际站运营
深圳市港基电技术有限公司	产品开发经理（美妆类目）高薪
深圳市卡格尔数码科技有限公司	海外销售精英（移动电源）
深圳多米尔箱包有限公司	美国业务特派员
深圳鸿兆科技有限公司	产品开发采购专员
深圳市德力普电池科技有限公司	高薪美国站亚马逊运营/专员/主管
深圳市睿益科技有限公司	ebay销售主管/ebay运营主管
深圳市富尼数字科技有限公司	国际贸易业务员
福瑞实业有限公司	亚马逊运营主管
深圳市一阳天翻译有限公司	国内销售
深圳瀚唯科技有限公司	eBay运营主管/eBay销售经理
天狐创意设计股份有限公司	礼品采购主管
深圳市猛狼科技有限公司	速卖通运营
深圳市富嘉辉精密电路科技有限公司...	物流专员
奥斯比科技(深圳)有限公司	项目管理专员 PM
深圳和乔科技有限公司	B2B 电商运营助理
深圳衣京服饰有限公司	阿里巴巴国际站运营
深圳市久通物联科技股份有限公司	西班牙语销售
深圳市锋拓科技有限公司	Amazon美国 销售
深圳市坪地奥力奇卫浴制品有限公司...	1688网络销售员
深圳市易贵科技有限公司	外贸业务员 外贸专员 主管 销售
深圳市恒泰博远贸易有限公司	亚马逊日本站主管
深圳新慧科技有限公司	国际运营
深圳狐客科技发展有限公司	跟单业务员
深圳迈腾云端科技有限公司	东南亚 Shopee 虾皮 电商运营 3C类
深圳市睿拓通科技有限公司	阿里国际站运营专员
深圳市超宏伟业电子有限公司	环球资源销售
深圳市宝兴德科技有限公司	亚马逊美国站业务员不加班
深圳市俊达运通国际物流有限公司	销售代表
深圳市博鹰国际货运代理有限公司	海外销售
深圳市优百色科技有限公司	亚马逊日语销售
众普森科技（深圳）有限公司	LED照明业务开发
深圳市鸿立达电子有限公司	阿里巴巴运营
深圳市创自技术有限公司	海外商务专员
深圳市易思特科技有限公司	亚马逊销售 （接受应届毕业生，上班地址：龙岗大运旁
深圳市华运国际物流有限公司	海外业务员
弘欧精密模具（东莞）有限公司	法语市场/业务
拓领环球货运代理有限公司	海运文件员 Documentation Clerk
深圳万国集通国际货运代理有限公司...	海外销售代表（北美）
深圳世杰斯微科技有限公司	Amazon销售/运营
深圳骑田贸易有限公司	亚马逊运营专员（应届毕业生）
深圳市智�Z科技有限公司	海外销售经理
深圳市真丽美尚国际贸易有限公司	共同创业/高薪急聘速卖通运营店长
深圳市美丽奥服装有限公司	生产计划经理
深圳市展翼尚品电子商务有限公司	会计/跨境电商会计
深圳市拓晋佳电子有限公司	亚马逊日语客服
深圳市夏湾科技有限公司	速卖通运营（坂田地铁站）
深圳市恒泰德电子商务有限公司	EDM营销专员/主管
深圳市优勤电子有限公司	高薪急聘+PCBA销售副总
深圳奥特斯电子商务有限公司	wish运营专员
深圳市恒锋科技有限公司	amazon亚马逊英语销售
深圳市一九八一科技有限公司	销售总监(急聘)
深圳市新埃法科技有限公司	高薪急聘海外销售人员
深圳市启鹏天辰科技有限公司	业务跟单
深圳市亿维特智能科技有限公司	阿里巴巴国际站运营/环球资源（双休+应届生）
深圳市金裕仁实业有限公司	跟单员
深圳市同为数码科技股份有限公司	海外商务专员
深圳市五光十色舞台设备有限公司	阿里巴巴国际站运营（急）
深圳市际德科技发展有限公司	亚马逊运营
深圳市腾申科技有限公司	跨境电商运营
深圳市触想智能股份有限公司	业务助理--应届生
深圳市地主贸易有限公司	采购专员/网采
广州市瑞新办公家具有限公司	亚马逊Amazon美工
深圳洛夫帝实业有限公司	电子烟销售精英
深圳市蓝图电子商务科技有限公司	Amazon美国站销售助理
深圳市普拓电子商务有限公司	产品开发 提供住宿
深圳市宇全创谷科技有限公司	网络销售
深圳市致远方物联技术有限公司	高薪诚聘外贸业务员/跨境电商专业英语翻译员
深圳市灏瀚传奇科技有限公司	B2C外贸销售/专员（应届生亦可）
深圳追随科技有限公司	高薪聘外贸业务员/亚马逊运营
深圳市坪山新区玉隆塑胶厂	外贸经理
深圳市迈顺源科技有限公司	外贸业务员
深圳市康福特塑胶电子有限公司	外贸市场营销
深圳市环球易达供应链管理有限公司...	B2B外贸销售
深圳辰达行电子有限公司	外贸销售
深圳佳泽光电有限公司	日语销售/日语外贸业务员
深圳市一琴数码有限公司	外贸业务员
深圳市安鑫视科技有限公司	外贸业务助理
深圳市家车宝智能科技有限公司	高级外贸业务员
深圳市雷亚德光电有限公司	LED外贸专员  精英（高底薪 +高提成+年终奖+旅游）
深圳意得尔电子科技有限公司	高薪聘请外贸业务员外贸销售
深圳市盛世丰科技有限公司	高薪诚聘外贸业务员/外贸专员
深圳市特格实业有限公司	外贸业务员+包住
深圳市艾尼亚电子科技有限公司	外贸业务员
施达沃防火科技（深圳）有限公司	外贸文员
深圳市兆新能源股份有限公司	外贸业务
深圳市乐贸通科技有限公司	外贸销售
Keyme Trading LTD	外贸采购/ 采购跟单
深圳市亿凯尔电子技术有限公司	外贸业务员 急聘
深圳市宝力威塑胶有限公司	外贸经理/外贸主管
深圳邦途科技有限公司	外贸业务员/速卖通运营/电商专员
深圳市多摩空间设计顾问有限公司	产品编辑/网页设计师（外贸类）
深圳市三匠电子商务有限公司	外贸亚马逊运营（双休+五险一金）
深圳茯苓科技有限公司	外贸经理
深圳市盛邦通信有限公司	外贸业务员
深圳市利鑫普电子有限公司	龙华智能穿戴 外贸业务员
祺泰实业（深圳）有限公司	外贸跟单员
新年华电子商务（深圳）有限公司	外贸助理（坂田地铁口+提成）
深圳市享易科技有限公司	诚聘eBay网络销售/外贸业务员（坂田地铁站附近）
深圳市联业光电技术有限公司	外贸业务员（接受应届生）
深圳市力腾电子科技有限公司	外贸业务员/应届毕业生/底薪6000起
前海鸿纬信息科技（深圳）有限公司...	外贸业务员（高提成+五险一金+包住+福田）
深圳市鸿威盛精密科技有限公司	外贸主管
深圳市嘉利成时计有限公司	腕表外贸业务员
深圳市华益兴科技有限公司	外贸业务员
深圳天丰泰科技股份有限公司	外贸专员
深圳市雅和达科技有限公司	外贸助理/应届毕业生/实习生
深圳市好写科技有限公司	外贸专员
深圳市中联华成数字技术有限公司	外贸业务员
深圳市永佳喷码设备有限公司	外贸专员
深圳市星际易购进出口有限公司	外贸业务员 阿里巴巴
深圳格林德能源集团有限公司	外贸经理
深圳市纽恩特实业有限责任公司	外贸跟单员
深圳市优迪尔科技有限公司	速卖通运营 销售 外贸业务员
深圳市安盈弘智能电子有限公司	外贸业务员(智能家居和安防)
北京英泰福贸科贸有限公司	外贸采购助理
深圳圣拓科技有限公司	高薪急聘外贸业务员 英语销售 外贸专员
深圳市特维克科技有限公司	外贸经理
深圳市联盈测控技术有限公司	外贸业务员
深圳市昌昊科技有限公司	诚招外贸业务员
深圳市高工电子有限公司	海外外贸业务员
深圳市弘毅电池有限公司	高薪聘请外贸业务
深圳市嘉怡兴科技有限公司	高薪招聘外贸业务员
深圳市兴科瑞拓科技有限公司	外贸助理
深圳市创力信电子有限公司	外贸运营专员
深圳市鼎跃科技有限公司	亚马逊产品编辑/外贸电商业务员
CRYPTON INTERNATIONAL LIMITED	业务跟单 外贸跟单
深圳市迈驰电子有限公司	高薪招聘外贸业务员
深圳市康宸电子科技有限公司	外贸经理
深圳市展驰橡塑有限公司	外贸业务员（包住宿，接受应届毕业生）
深圳市远东静电科技有限公司	外贸销售
深圳市海蒂科技有限公司	外贸业务员
深圳市乐华多媒体科技有限公司	外贸业务员
深圳市万诚通电子有限公司	外贸业务员（双休+双地铁）
深圳市帆龙威电子科技有限公司	外贸专员
深圳鸿彩数码有限公司	外贸专员
深圳市合元科技有限公司	外贸跟单
深圳市奥瑞金纺织有限公司	外贸面料跟单员
深圳市掌易科技发展有限公司	外贸业务员
深圳市鹏越玩具有限公司	高级外贸业务员
深圳欣盛商科技有限公司	外贸客服（武汉）
深圳市东煜金属材料有限公司	外贸跟单员
谷盛有限公司	PCB外贸跟单/助理/销售
深圳市斯维普科技有限公司	外贸经理（电子烟行业）
深圳市布宜诺科技有限公司	外贸助理 速卖通运营助理 销售助理
深圳市绿蒂丝科技有限公司	Amazon亚马逊产品开发经理/外贸产品经理
深圳市鸿达顺科技开发有限公司	外贸业务员
深圳市美阳玻璃制品有限公司	外贸业务员/B2B销售
深圳市新安成科技有限公司	外贸跟单员
深圳市舒特帐篷有限公司	外贸推广/外贸运营/运营专员
深圳市海晨科技有限公司	外贸业务员
深圳市浩必达科技开发有限公司	外贸专员/亚马逊销售/运营
深圳市杨美科技有限公司	外贸经理/外贸主管（急聘）
深圳市壹中鑫实业有限公司	外贸业务员/速卖通销售
深圳禾瑞森实业有限公司	农药外贸销售
深圳普乐电路有限公司	外贸业务员(接受应届生)
深圳阿尔沃贸易有限公司	外贸电商采购专员 网络采购  采购跟单
兰博世通科技（深圳）有限公司	外贸运营（lazada运营主管+高薪）
深圳市安博特电源设备有限公司	外贸业务员
深圳贝亨达科技有限公司	外贸业务员 B2B 阿里巴巴 双休
深圳市思博科创有限公司	外贸/贸易专员//外贸业务员
深圳市世亮照明有限公司	外贸精英 双休
联正晟（深圳）实业有限责任公司	采购跟单/外贸跟单/业务跟单
深圳市明扬力天电子商务有限公司	外贸业务
深圳市久鼎精密科技有限公司	外贸专员
深圳市日达特电子有限公司	外贸业务员/外贸销售
沃格模具科技（深圳）有限公司	外贸专员（应届毕业生）
深圳市猎英时尚资讯有限公司	外贸经理 （佛山）
深圳特迪科技有限公司	外贸业务员/B2B/阿里巴巴国际站/社保/大小周
深圳市威拓思音乐有限公司	外贸销售
深圳市亿斯电子商务有限公司	Amazon外贸业务员
深圳市东兴岳科技有限公司	外贸业务员
深圳市竹天科技有限公司	外贸经理
深圳德蒙玩具设计开发有限公司	外贸业务员（龙岗双休）
深圳市益之星实业有限公司	外贸业务员外贸销售华强北(高薪急聘)
深圳市卡联科技股份有限公司	外贸业务员
深圳市盛邦华科技发展有限公司	外贸业务员
深圳市乐瑞科技有限公司	外贸业务跟单/oversea sales
东莞市民兴电缆有限公司	外贸总监/海外市场总监
深圳市可视三帝礼品有限公司	阿里巴巴运营/销售/外贸业务员
深圳市润东动漫科技开发有限公司	外贸业务员 外销专员 高级外贸员
东沃实业发展（深圳）有限公司	外贸销售（包住+双休）
深圳市特品特印刷设备有限公司	外贸/贸易专员/助理
深圳市中通进出口有限公司	外贸业务助理
深圳市鑫迈瑞电子科技有限公司	外贸经理 外贸主管 外贸合伙人
深圳市胜兴科技有限公司	外贸经理
新纬图实业有限公司	外贸业务员
深圳市精致阁美容用具有限公司	外贸跟单员
深圳市素心科技有限公司	外贸客服
深圳市荣者光电科技发展有限公司	外贸跟单
深圳市壹米国际科技有限公司	英文外贸电商文案编辑
深圳市欧米达电子有限公司	外贸跟单员
深圳市迈斯特体育用品有限公司	外贸专员(湖南蓝山县工业园区上班）
深圳明善光电有限公司	北美LED外贸业务
深圳沃丰科技有限公司	外贸业务员/外贸销售
德兴璞电子（深圳）有限公司	外贸销售
深圳市柏创新能源实业有限公司	外贸业务员/应届毕业生
东科半导体科技（深圳）有限公司	外贸主管
深圳市福田区安田通信产品	采购员/外贸采购（急招）
深圳市富斯泰网络技术有限公司	B2B外贸主管
深圳市优泰钟表有限公司	外贸总监
深圳名彩智能卡有限公司	外贸专员
深圳市艾斯威普科技有限公司	急招+外贸专员
深圳市协珲饰品有限公司	外贸业务员
深圳市信嘉科技有限公司	外贸销售员
深圳市小黄豆科技有限公司	外贸销售
深圳市首通新能源有限公司	B2B外贸业务员
深圳舒帮达科技有限公司	外贸业务员
深圳市同创塑胶制品有限公司	外贸销售经理  外贸主管
深圳市川崎运动用品有限公司	外贸业务员(川崎步欧）
深圳市锐驰曼科技发展有限公司	外贸专员（深圳，外贸业务代表，急聘）
深圳市跨界音乐器材有限公司	外贸销售
深圳市邦尼森汽车部件有限公司	外贸专员
深圳市伟宏眼镜有限公司	外贸销售
佛山市宝诺贸易有限公司	外贸跟单员
深圳市鑫宏博照明有限公司	外贸业务经理
深圳市普利尔德科技有限公司	外贸电商配货打包员
深圳市尤尼特电子有限公司	外贸业务员
蓝牛国际物流（深圳）有限公司	国际物流外贸业务员
深圳市极品环球商贸有限公司	外贸专员
沙皇管理咨询（深圳）有限公司	贸易/外贸专员/助理
深圳市隆盛威贸易有限公司	亚马逊运营师
深圳市聚科时尚科技有限公司	Amazon亚马逊运营
深圳莱欧源科技有限公司	Ebay运营
深圳市刻锐智能科技有限公司	亚马逊高级运营/主管
深圳市三只蜜蜂电子商务有限公司	亚马逊日语销售/运营
沃通电子认证服务有限公司	英语商务
深圳市枪花实业有限公司	淘宝美工 网页美工  平面设计
深圳市四海芯舟科技有限公司	Cdiscount法语销售专员/组长
深圳市科润斯科技有限公司	海外销售
深圳市超频三科技股份有限公司	亚马逊/ebay运营主管
深圳市阿拉拉电子商务有限公司	亚马逊广告助理/站内推广/双休
深圳市正京文化传播有限公司	软件销售
深圳市欧得宝翻译有限公司	香港销售客服
深圳市金创钜电子科技有限公司	国内蓝牙耳机业务员
深圳市海科盛科技有限公司	网络推广专员
深圳市通拓科技有限公司	速卖通主管
深圳市瑞博塑料包装有限公司	阿里巴巴运营
深圳市光合种植有限公司	日本电商平台乐天销售经理
深圳市丰收物流有限公司	销售代表
深圳市鼎森电子科技有限公司	财务专员（全盘） 周末双休
深圳市达聚科技有限公司	亚马逊销售 英语客服 英语翻译
深圳市博屹电子有限公司	跨境电商运营
深圳市兰保斯科技有限公司	亚马逊销售/亚马逊运营
深圳市千粒子科技有限公司	高薪  速卖通资深运营/店长/主管（深圳坂田）
深圳市可诺可科技有限公司	阿里巴巴国际站运营
深圳市长坤国际物流有限公司	海外客服
深圳市圣汇人工智能有限公司	亚马逊运营专员
深圳锐力时计表业有限公司	亚马逊主管/组长（欧洲站）
深圳市森泊科技有限公司	亚马逊运营专员
深圳市思美化妆品有限公司	跨境销售助理
上海赢他网络科技有限公司	海外推广/facebook推广（双休）
深圳市畅海国际物流有限公司	海运业务员
深圳市新网力拓贸易有限公司	Ebay助理
深圳市小怪兽教育科技有限公司	亚马逊运营专员
深圳市利朗达科技有限公司	ebay客服组长
深圳市欧尚亚科技有限公司	亚马逊销售（欢迎应届生）
深圳市恒辉达实业有限公司	亚马逊运营
深圳斯百特电子有限公司	人事行政专员
深圳千浔电商科技有限公司	亚马逊运营(双休)
深圳市金佳利机电有限公司	CNC技术员/CNC师傅
深圳市昊通国际物流有限公司	海外业务员
深圳市奥多科技有限公司	电商理货员打包员
深圳市小布丁电子商务有限公司	亚马逊运营专员
英特体育发展（深圳）有限公司	Garment Merchandiser 服装跟单员
深圳市东昂科技有限公司	网络销售
深圳市纵维立方科技有限公司	eBay销售/eBay运营
深圳市易百珑科技有限公司	国外销售经理
深圳市华远国际物流有限公司	海外销售代表
深圳市振欢电子有限公司	财务专员
深圳市嘉航伟业物流有限公司	进出口操作
深圳市小飞鸟科技有限公司	亚马逊运营主管
深圳市五轮电子股份有限公司	阿里巴巴运营专员
深圳市天美意科技有限公司	跨境电商运营助理
深圳市伊利诺斯科技有限公司	亚马逊美工/电商美工
深圳市环球一百电子商务有限公司	诚聘Amazon运营/销售
深圳市广易达电子商务有限公司	外贸 外贸专员 外贸业务员 跨境电商 不限经验
太龙（福建）商业照明股份有限公司...	部门助理
揭阳市至远鞋业有限公司	亚马逊产品开发专员
深圳市元泰实业有限公司	国内销售
深圳市众维网络科技有限公司	英语编辑/英语客服（EBAY）
深圳市振弘陶实业有限公司	高级跟单员
深圳市北辰全球贸易有限公司	亚马逊欧洲站运营
深圳市东业腾飞电子有限公司	亚马逊美国站/欧洲站运营
深圳市世倡货运有限公司	操作
深圳柏雅俐珠宝有限公司	质检QC
深圳市安斯顿科技有限公司	亚马逊销售
深圳市艾维尔电子商务有限公司	亚马逊运营专员（美国站日本站）
深圳市嘉豪廷电子有限公司	Lazada / Shopee运营/销售
深圳红狼网络科技有限公司	亚马逊销售+双休/德国美国西班牙
深圳宝易聚科技有限公司	亚马逊运营专员
深圳市创世华联科技有限公司	阿里巴巴国际站运营
深圳市沃之莱科技有限公司	Shopee运营/虾皮销售
深圳市齐奥通信技术有限公司	充电类产品经理
深圳市莱斯特科技有限公司	产品开发专员/供应商开发
深圳市温仕达电子科技有限公司	亚马逊销售运营（精品）
深圳市爱图仕影像器材有限公司	日语应届生
深圳市鸿鑫祺服饰有限公司	跟单/外贸跟单/服装跟单/外贸服装跟单
深圳市佳韵丰舞台设备有限公司	总经理助理
深圳市海科家居用品有限公司	采购跟单
深圳市朗科科技股份有限公司	国际销售（闪存、SSD类存储）
深圳市军灿电子商务有限公司	Ebay销售助理
深圳市思睿国际货运代理有限公司	货代操作
深圳市艾客智客科技有限公司	亚马逊销售/亚马逊运营
艾姆勒海外仓储(深圳)有限责任公司...	速卖通运营
深圳尚睿贸易有限公司	产品开发专员8K-1.2W
深圳市嘉腾贸易有限公司	eBay销售
深圳前海启晋供应链有限公司	亚马逊站外推广
深圳诺泰科电子有限公司	亚马逊站外推广
深圳市旭弘翔电子有限公司	国内业务员
深圳市领锐光电有限公司	国际销售
深圳市时商创展科技有限公司	速卖通运营
深圳金百新电子有限公司	德国站亚马逊销售
深圳市鑫思创贸易有限公司	eBay销售
深圳市欧米精密工业有限公司	海外销售工程师
深圳市小洲硅胶生活用品有限公司	内贸经理
深圳市炬神电子有限公司	阿里巴巴国际业务
东莞市奥海科技股份有限公司	销售经理（东莞塘厦工作，免费提供食宿）
亚利韦(深圳)科技实业有限公司	阿里巴巴国际站运营
万代兰企业咨询管理(深圳)有限公司...	贸易营业（龙岗）
深圳市旭佳实业有限公司	销售业务专员/主管
茂鑫源电子（深圳）有限公司	各岗位储备干部
深圳市艾姆诗数码科技有限公司	英语客服（无需经验）
深圳市便携电子科技有限公司	销售跟单员
深圳市本色不锈钢饰品有限公司	销售代表
深圳市丽晶光电科技股份有限公司	国际销售员/销售跟单
深圳耐能达科技有限公司	亚马逊销售 一年经验
深圳市美克能源科技股份有限公司	运营专员（国际）
深圳市臻致网络科技有限公司	亚马逊运营专员
深圳市锐讯天成科技有限公司	Lazada/shopee运营
深圳格威科技有限公司	亚马逊销售主管
深圳市光子跃动科技有限公司	跨境招商经理
广东百聚汇企业管理咨询有限公司	网络销售 应届毕业生
深圳垦拓流体控制有限公司	国际市场部经理
深圳正和奇胜科技有限公司	亚马逊欧美站运营经理
深圳市建源达镜业科技有限公司	亚马逊运营专员
深圳市中电汇通国际物流有限公司	海外客服/业务
深圳特瑞克科技有限公司	电子元器件英语销售
深圳翌靖新材料有限公司	海外销售代表（双休+提成）
深圳市节源科技有限公司	国内业务员
深圳市奥拓德科技有限公司	高薪诚聘―电商产品开发
深圳微步信息股份有限公司	海外业务员（厦门）
深圳大东亚包装设计有限公司	跟单员/业务跟单/采购助理/双休
深圳市道恩模型科技有限公司	亚马逊日语销售助理/速卖通
深圳市亚鑫优品电子商务有限公司	亚马逊日语销售
深圳右食指网络科技有限公司	亚马逊销售
美国南方电信有限公司深圳代表处	Merchandiser（双休+急聘）
深圳市永盛帝珠宝有限公司	物流专员转测试
深圳市凯码时代科技有限公司	日语业务跟单助理
深圳市墨兰国际物流有限公司	货代海外销售+高薪+免费培训
深圳市亚婷贸易有限公司	wish销售运营
海连（中国）国际货运有限公司	货代销售
深圳市星之翼科技有限公司	跨境电商客服/助理
东莞市宏源净化设备有限公司	跨境电商运营主管
深圳市赤道科技有限公司	渠道销售/渠道经理/渠道专员
怡然家居用品有限公司	业务专员
深圳市海贝利科技有限公司	eBay 速卖通 实习生
深圳市通达全球电子商务有限公司	亚马逊销售
深圳市瑞凌实业股份有限公司	海外销售代表
深圳市科羽科技发展有限公司	市场推广专员
深圳市棒果网络科技有限公司	亚马逊 amazon  wish 销售运营（6K+高提成）
深圳市德沃瑞科技有限公司	电商运营
深圳向小葵贸易有限公司	EBAY业务员 EBAY销售
深圳市晟技科技有限公司	亚马逊销售
深圳市信创达机电设备有限公司	日语跟单
深圳金鑫世纪实业有限公司	阿里巴巴国际站运营专员
深圳市胜威南方科技有限公司	大客户销售专员
惠州市成飞实业有限公司	电子商务专员
深圳市德安泰防护科技有限公司	消防救援产品经理
深圳市青鸾电子科技有限公司	国内业务员
深圳市中荣威科技有限公司	亚马逊销售人员
深圳市时利信电子有限公司	海外销售
深圳力思诺贸易有限公司	新品开发
深圳市易仓科技有限公司	物流产品经理
深圳尚霓金属制品有限公司	B2B外贸业务员/外贸助理/外贸专员/应届毕业生
深圳博澄科技有限公司	亚马逊/amazon运营 销售 （社保，每年3次加薪）
深圳市源林电子商务有限公司	高薪诚招亚马逊运营组长美国站
山东晶泰星光电科技有限公司	英语翻译--山东泰安
深圳市狮狼科技有限公司	亚马逊运营总监（双休）
深圳万润科技股份有限公司	facebook推广（东莞）
深圳立源远科技有限公司	日语销售助理
深圳嘉里盐田港物流有限公司	操作文员
深圳市诺欧电子商务有限公司	产品开发（接收应届毕业生）
深圳市中建创拓贸易有限公司	亚马逊推广
深圳爱升精密高科有限公司	海外销售
深圳市鼎维尔科技有限公司	商务跟单
深圳市正拓供应链管理有限公司	采购员 深圳龙华
深圳勃兰多科技有限公司	国际贸易专员
万贯婚纱（深圳）有限公司	文员（应届生高中或大学）
深圳市利霖欣科技有限公司	亚马逊销售
深圳市赛纳电子科技有限公司	亚马逊西班牙语运营（精品）
深圳市欧力泰电子科技有限公司	亚马逊日语销售
皇室堡集团海外房产	海外投资顾问
深圳市华坤实业发展有限公司	wish销售、主管（高提成+高薪+年终分红）
深圳市地纯贸易有限公司	亚马逊销售
深圳摩罗志远科技有限公司	资深亚马逊运营
深圳市中海通物流股份有限公司	项目总监
深圳市亚广展览有限公司	外展销售/业务员
中航狮威国际货运代理有限公司深圳...	海运文件/海运单证员
深圳市统卓网络科技有限公司	Amazon销售运营亚马逊
深圳市烈焰科技有限公司	SEO优化/shopify运营
深圳亮视光学科技有限公司	海外独立站运营
深圳市知翼科技有限公司	俄语销售
深圳信扬国际经贸股份有限公司	大宗贸易经理
深圳德凯国际货运代理有限公司	国际海运空运操作/货代操作
深圳市宝威特电源有限公司	阿里巴巴国际站运营
上海恒扬国际物流有限公司	Operation Supervisor 操作主管
深圳市金路捷科技有限公司	亚马逊运营销售
深圳华悦国际物流股份有限公司	急招海空运操作
怀德维新金属制品（深圳）有限公司...	英语营业员
深圳市新达商汇电子商务有限公司	亚马逊销售-英语 周末双休
深圳市安加电子商务有限公司	Aliexpress速卖通销售
深圳市优威视讯科技股份有限公司	客服经理
深圳市�h芯通科技有限公司	亚马逊运营专员
深圳市研锋科技有限公司	高薪聘请LED灯具国际销售
深圳市鑫尼达科技有限公司	亚马逊销售
深圳市普光太阳能有限公司	Ebay运营 （高提成）
深圳市润步科技有限公司	亚马逊产品开发
深圳市贯垄农产品有限公司	财务高级经理
深圳瀚格飞科技有限公司	仓库操作员
亿泰和信息技术（上海）有限公司	分公司总经理
深圳市龙腾世纪科技商贸有限公司	Amazon亚马逊运营/亚马逊销售
东莞市博才慧成企业管理咨询有限公...	速卖通运营
深圳新蜂供应链管理有限公司	英语业务助理
深圳市迅拓达科技有限公司	亚马逊运营专员
深圳市金多多食品有限公司	产品开发/发展/设计/项目工程师
深圳市坤之拓商贸发展有限公司	亚马逊运营/亚马逊销售 年底双薪
深圳市越宏普照照明科技有限公司	亚马逊销售
深圳太阳升贸易有限公司	阿里巴巴国际站运营
深圳市爱夫卡科技股份有限公司	海外销售
深圳市恒华威电子科技有限公司	高薪诚聘亚马逊日本站运营
深圳市众力威科技有限公司	应届毕业生招聘
深圳市铭祥达电子有限公司	业务助理
深圳市西迪特科技有限公司	国际销售
香港通程有限公司深圳代表处	业务跟单
深圳市华杰电子商务有限公司	跨境电商运营助理（不要求经验，0基础培训）
思齐软件（深圳）有限公司	管理培训生（优秀应届生奖学金）
深圳市诺欣宏远商贸有限公司	办公室文员
深圳市翱琥科技有限公司	亚马逊精品产品经理
深圳市德斯林克科技有限公司	速卖通运营/坂田地铁口
深圳卡明速运有限公司	会计经理
深圳市钜泰通信技术有限公司	实习销售助理
深圳市同创盈科技有限公司	市场推广专员
深圳市劳斯韦伯科技有限公司	总经理助理
深圳市新意多科技有限公司	急聘国际阿里业务
深圳市联通达塑胶五金有限公司	亚马逊销售专员
深圳市麦储科技有限公司	海外销售经理
深圳市芯电易科技股份有限公司	电子元器件进口报关事业部负责人
深圳市恩宇达科技有限公司	亚马逊测评专员
深圳市小小工匠科技有限公司	日语亚马逊销售 亚马逊日本站运营（宝安西乡）
深圳市特易迈科技有限公司	亚马逊日语运营
深圳市佛光照明有限公司	国际贸易销售
深圳市维客斯科技有限公司	船务跟单
深圳市伊诺瓦光电科技有限公司	西班牙语业务员
深圳市京泰防护科技股份有限公司	船务单证员
深圳市爱沃森科技有限公司	速卖通运营助理（包住）
深圳市元美供应链管理有限公司	跨境电商运营助理（急）
深圳市泛华卓运国际物流有限公司	销售代表
深圳市西岸国际货运有限公司	商务助理 销售助理 双休
深圳市江波龙电子股份有限公司	海外销售经理
深圳樱吉尔企业咨询管理有限公司	日语亚马逊运营
深圳市淳峰科技有限公司	速卖通销售
深圳市鸿之�N科技有限公司	亚马逊销售(会日语）
深圳市乐信兴业科技有限公司	美国站亚马逊运营
深圳市昂威安科技有限公司	采购开发/产品开发
上海载和网络科技有限公司	跨境电商Aliexpress客服助理
长园集团股份有限公司	谷歌推广专员（长园特发-光明新区）
深圳市友鹏包装制品有限公司	外贸/贸易专员/助理/外贸业务员
深圳市阿尔法通讯技术有限公司	国内销售
深圳市铭兴电子商务有限公司	亚马逊运营专员
精奥科技（深圳）有限公司	财务经理
深圳市莱特豪光电科技有限公司	跨境电商运营
深圳艾斯特创新科技有限公司	业务跟单（欢迎应届毕业生）
深圳金亚太科技有限公司	海外销售
香港易道时代科技有限公司	Ebay销售/客服/运营
深圳市思诚优品电子商务有限公司	开发专员
深圳市宏飞兴业电子科技有限公司	阿里国际站运营/五险
深圳市光澜世纪电子有限公司	亚马逊销售主管
英创人力资源服务（深圳）有限公司...	日语电子元器件销售-日资（编号 10095299）
深圳市恒之讯科技有限公司	shopee虾皮运营/销售
深圳市拓百川电子科技有限公司	亚马逊销售（午餐+双休+精品）
深圳市盛帝森科技有限公司	亚马逊运营专员
深圳君威国际货运代理有限公司	无责任底薪+招聘业务储备干部全职
广州华众达户外箱包有限公司	亚马逊销售
深圳市福斯康姆智能科技有限公司	海外推广
深圳市博洋包装制品有限公司	高级业务跟单
深圳乐戏发光科技有限公司	高级业务跟单
深圳市联科思电子有限公司	亚马逊运营专员（精品）
深圳市兴华威衣帽有限公司	外贸业务员/外贸专员/外贸销售/外贸跟单
常熟微腾电子商务有限公司	微信销售
奥斯比电子（深圳）有限公司	英文电话销售
深圳全球立达供应链管理有限公司	归类专员（海运操作）
深圳市智美德科技有限公司	销售代表
深圳市锦通云商科技有限责任公司	亚马逊铺货运营
深圳宏通源科技有限公司	法语运营 CD销售 助理
深圳市优特电子有限公司	产品工程师（连接器类）
深圳市嘉宝莱科技有限公司	亚马逊运营助理
深圳市长科顺科技有限公司	电子元器件采购
深圳市联图腾科技有限公司	速卖通shopee销售/电商专员/速卖通运营（应届生）
深圳市祈智电子有限公司	亚马逊销售主管
深圳市泰旭进出口有限公司	报关业务
香港克拉西客配件（亚洲）有限公司...	产品开发专员
深圳市微智盛电子商务有限公司	亚马逊站外推广
浙江胜马国际货运代理有限公司深圳...	国际部销售
深圳市海威顺达国际货运代理有限公...	货代操作员
深圳市顺淇科贸有限公司	亚马逊美国站产品开发
The Studio（中国）	袜子跟单
深圳市源欣实业有限公司	阿里巴巴国际站运营
深圳酷卡仕科技有限公司	全盘会计
深圳市维嘉电路科技有限公司	pcb销售业务员
深圳创实技术有限公司	销售助理
深圳市欣盛饰品有限公司	开发打样员
深圳市威嘉国际货运代理有限公司	应届毕业生
深圳市大树电子商务有限公司	亚马逊销售助理 英语（应届毕业生+专业培训）
深圳市景瑞科技有限公司	福永内贸销售
深圳市嘉德信通国际物流有限公司	货运代理业务精英
深圳市威途科技有限公司	亚马逊销售运营-应届毕业生
千禧国际货运代理（深圳）有限公司...	文件主管
深圳市雾派科技有限公司	国内销售助理
深圳市乐有家房产交易有限公司	销售实习生，提供住宿，导师带教
深圳首石科技有限公司	亚马逊服务助理
深圳市极光尔沃科技股份有限公司	阿里巴巴国际站运营
深圳市迪品乐科技有限公司	阿里巴巴国际站运营
深圳市翊翊科技有限公司	阿里巴巴国际站运营
深圳三羊塑胶五金有限公司	销售经理
深圳市泰兴星科技有限公司	Ebay销售主管
深圳市都市网络科技有限公司	南山接听客服月薪8K（包吃住）
深圳市鸿鹏进出口有限公司	跟单文员
深圳科雷照明科技有限公司	俄语销售
深圳市腾拓科技有限公司	亚马逊运营经理（欧洲站）
深圳市仟仪科技有限公司	亚马逊运营专员/电子商务专员+双休包住
杰亮光电照明（深圳）有限公司	英语翻译
深圳市鑫泽源国际供应链管理有限公...	产品开发（周末双休）
深圳市致信国际货运代理有限公司	海运业务员
深圳安吉斯电子商务有限公司	速卖通运营
雷特网络科技有限公司	产品信息管理员（文职岗）
连龙兴技术咨询（深圳）有限公司	日语生产营业
深圳云润服饰有限公司	跨境电商运营主管
北京宜选科技股份公司	客户关系专员
深圳市宜思创科技有限公司	全盘会计
深圳市万年跨境电商有限公司	亚马逊销售主管（欧洲站）
深圳小辣椒科技有限责任公司	海外商务专员
深圳市零创汽车用品有限公司	海外销售业务员
深圳市鑫盛泰光电有限公司	急招美工
深圳市鑫宏茂光电有限公司	跨境电商运营
深圳市海外仓贸易有限公司	急招仓库文员/仓库理货员
深圳市四海众联网络科技有限公司	速卖通运营（精品模式/高提成/90后工作氛围/不加班）
深圳市凡品源科技有限公司	应届毕业生/亚马逊业务员/坂田地铁口
深圳市格镭激光科技有限公司	国际贸易业务员
深圳市德铭光科技有限公司	船务
深圳市鑫顶航纺织品有限公司	B2B国际站主管
深圳市奥麦斯智能创新有限公司	亚马逊推广/运营  实习生
深圳大象共和网络有限公司	亚马逊运营组长美国站（周末双休 精品运营）
深圳市利尔机械设备有限公司	商务助理
广州奥鹏能源科技有限公司	Amazon亚马逊运营
深圳市大获科技有限公司	亚马逊运营专员
哈其德（深圳）国际货运代理有限公...	海运操作 文员
讯大网络科技（深圳）有限公司	产品开发主管
深圳市深科诺科技有限公司	ebay销售专员
深圳市海源汇电子科技有限公司	Amazon销售助理/亚马逊客服
深圳市圆方贸易有限公司	亚马逊运营助理
深圳乐创科技开发有限公司	亚马逊运营专员
深圳市钰捷兴科技有限公司	双休/法语亚马逊运营/跨境电商/Amazon销售/外贸业务员
深圳千墨文化传播有限公司	英语客服（5-10K）
深圳市云鼠科技开发有限公司	亚马逊运营（德法语都可）
东莞市一虎实业有限公司	销售代表（绩效奖金）
深圳市赛康德生物科技有限公司	总经理助理(英文翻译)
上海艾杰飞人力资源有限公司	日企营业担当(编号106486) 日语必须
深圳市睿联数字技术有限公司	海外销售助理
易通全球跨境电商（深圳）有限公司...	平台运营专员
深圳市海瑞丰企业服务有限公司	退税会计
深圳市卓力能电子有限公司	大客户经理
深圳市名�N贸易有限公司	采购员/跟单员
深圳市千姿美化妆品有限公司	急聘电商运营
深圳市巴莫尔时尚珠宝有限公司	Cdiscount运营
深圳万百万科技有限公司	亚马逊运营销售（德国站+提成+双休）
深圳市泽宝电子商务股份有限公司	意大利语亚马逊销售
深圳市派克包装制品有限公司	印刷包装采购
集海科技（深圳）有限公司	海外推广
深圳市卡古科技有限公司	德语翻译/运营/线上销售
华瑞研能科技（深圳）有限公司	电商选品/新品开发员
深圳市炫酷国际电子有限公司	亚马逊欧洲站运营
深圳市揽众科技有限公司	亚马逊运营助理
深圳市嘉卡智能科技有限公司	淘宝美工/平面设计
深圳雅龙家居饰品有限公司	亚马逊运营专员
深圳市威森模具技术有限公司	销售助理
明辉实业（深圳）有限公司	英语专业应届生
深圳市捷思互联科技有限公司	销售助理/应届生
深圳伊卡普科技有限公司	营销总监  高薪
深圳市润丰数码技术有限公司	(急聘）Amazon法国站运营专员
深圳安普国际物流有限公司	海外销售
深圳前海赛迪电子商务有限公司	Amazon运营/亚马逊销售
深圳童品荟科技有限公司	销售文员，跟单，外贸，文员
深圳市唐诚兴业科技有限公司	销售跟单
深圳市美乐德商务服务有限公司	日语运营推广
深圳市赫兹科技有限公司	海外销售助理
深圳前海帕拓逊网络技术有限公司	采购工程师
深圳市安卓尔科技有限公司	海外推广主管
深圳锦帛方激光科技有限公司	海外业务经理
深圳富士伟业科技有限公司	应届毕业生
深圳市睿搏科技集团有限公司	Amazon德国站销售
深圳市金泰明电子科技有限公司	德语业务员
深圳市奥艺美科技有限公司	亚马逊运营经理
深圳市新易迅科技有限公司	PHP开发工程师
深圳市鑫祺贸易有限公司	shopee运营 电子商务专员 跨境电商运营
深圳市易信元科技有限公司	亚马逊销售运营 欧洲站
深圳优艺体育设备有限公司	国际贸易专员
深圳市环球易购电子商务有限公司	阿里巴巴国际站运营
深圳市领悦科技有限公司	采购/福永地铁站附近
深圳市西摩科技有限公司	亚马逊运营专员
德尚酒店设备设计（深圳）有限公司...	海外销售
深圳市极客光电有限公司	产品摄影师（福永地铁站旁）
神能照明（深圳）有限公司	外贸业务员 应届毕业生优先
深圳市盛视电子商务有限公司	外贸专员 跨境电商运营 快速晋升 靠近地铁站
深圳市丽显光电有限公司	外贸业务员
深圳求势创新科技有限公司	外贸业务员
深圳谱达实业有限公司	外贸助理
深圳市爱武科技有限公司	外贸业务员
斯莫（香港）有限公司	外贸跟单
深圳爱可维水处理设备有限公司	外贸销售
深圳市菲美特科技有限公司	外贸业务员 / 跟单
深圳市英利印刷有限公司	外贸业务员
深圳展图科技有限公司	英语客服/外贸客服/亚马逊客服
深圳市苏奔科技有限公司	高薪诚聘天猫美工/外贸美工
深圳市东成电子有限公司	外贸助理
深圳鑫伊翔贸易有限公司	外贸业务员
深圳市德宣科技发展有限公司	外贸专员
深圳市优奇文化发展有限公司	化妆品销售外贸业务5k起+社保 地铁口上班
深圳视觉科技有限公司	市场营销（外贸）
天马微电子股份有限公司	外贸销售高级专员（英语/韩语/日语）
深圳市女娲机器人科技有限公司	外贸跟单员
深圳市卓越腾达科技有限公司	外贸美工/平面设计/网店美工
深圳市联诠电子科技有限公司	IC外贸专员
深圳市鑫源通电子有限公司	外贸业务员（龙岗平湖）
深圳市沃蕾特饰品有限公司	外贸主管
深圳市镒泊森模具有限公司	外贸业务员
聚豪塑胶制品（惠州）有限公司	外贸业务员（惠州）
深圳市物联电子有限公司	外贸业务员
蓝睛科技（深圳）有限公司	外贸推广
深圳市德诺进出口有限公司	外贸跟单员
金旭环保制品（深圳）有限公司	外贸跟单员
深圳市易视达显示科技有限公司	急聘高级外贸跟单
深圳市拓峰电子商务有限公司	ebay/速卖通/wish/shopee 销售 外贸业务
深圳仁瓷实业有限公司	日用陶瓷外贸经理
费赛客科技（深圳）有限公司	外贸跟单员
深圳启泰饰品有限公司	外贸跟单员（高薪+五险一金）
深圳赛和电子有限公司	外贸
深圳市国晨光电科技有限公司	外贸运营助理/英语客服（应届生）
深圳市女都服装有限公司	外贸业务员
深圳市神火光电设备有限公司	外贸业务员
中山市飞达脚轮有限公司	外贸业务员
深圳市卡酷特科技有限公司	外贸业务员
深圳壹方创新技术有限公司	德语外贸销售专员/德语外贸业务专员
深圳市鑫宝达电机有限公司	外贸经理
深圳市标杆教育科技有限公司	外贸顾问老师
深圳市绿森照明科技有限公司	外贸助理跟单（应届毕业生优先）
深圳市绿建模型设计有限公司	外贸业务员
深圳市南天投资有限公司	速卖通外贸客服
深圳市穆林泰电子有限公司	阿里国际站高级业务员/外贸专员/外贸销售      高底薪
深圳市易碟美贸易有限公司	亚马逊运营/外贸运营（美国站）
钧阳（深圳）发展股份有限公司	外贸业务员
深圳市卓茂科技有限公司	外贸业务员
深圳市亿舒华光电有限公司	外贸主管
深圳市联创电器实业有限公司	外贸业务-日语
深圳市新光芯制器件有限公司	外贸业务/外贸跟单
惠州市鑫泰无纺布有限公司	外贸业务员
深圳市宾享时代科技有限公司	外贸业务员
深圳市鑫岛精密模具有限公司	外贸业务员
深圳市绿色维度贸易有限公司	外贸电商销售助理
深圳市盛祥科技开发有限公司	外贸业务员
深圳市赛航科技有限公司	外贸业务员
深圳美诺迪科技有限公司	外贸业务员
深圳市瑞森纳箱包有限公司	外贸业务员
汕头市茂发食品有限公司	外贸业务员
深圳市亮鹏科技有限公司	外贸业务员
深圳市讯晨科技有限公司	外贸跟单
深圳市梧桐在线科技有限公司	外贸助理
中建材资源有限公司	外贸跟单员
深圳市畅行未来智能科技有限公司	外贸业务助理
深圳市艾迪凯科技有限公司	外贸业务助理
深圳市宏谛翔科技有限公司	外贸业务/外贸专员（高薪诚聘）
深圳市科达表业有限公司	运营主管/阿里巴巴运营专员/外贸运营/跨境电商业务员
深圳市腾东电子商务有限公司	应届管培生/外贸经理助理/Amazon
深圳市博泰纺织有限公司	外贸跟单员
深圳市文鼎特电子科技有限公司	外贸业务员/外贸专员/国际销售员 (周末双休 龙岗坂田)
厦门诺胜物流有限公司	海外业务员 外贸 海外销售 海外市场
深圳市大成智胜电子商务有限公司	高薪 外贸商务助理 / 客服 英语六级以上-欢迎应届生
深圳市慧视通科技股份有限公司	外贸技术支持工程师
深圳玮渤科技有限公司	底薪5K起急聘外贸销售
东莞泰山电子有限公司	外�Q跟��
深圳前海零距物联网科技有限公司	外贸跟单员
深圳市睿智云科技有限公司	外贸业务员
深圳市赤之惠电器有限公司	外贸跟单员
深圳林格斯商贸有限公司	amazon亚马逊跨境电商外贸运营主管
深圳千里蓝途企业咨询管理有限公司...	阿里国际站外贸业务员
深圳瑞视达科技有限公司	外贸跟单员（急招：提供住宿）
深圳市汉东玻璃机械有限公司	外贸助理
深圳市利拓微科技有限公司	高薪急聘外贸业务跟单
韩国株式会社JMEDIGITAL深圳代表处...	外贸跟单员（日韩语）
宝利时（深圳）胶粘制品有限公司	外贸业务员
深圳市宝宏宇塑胶绳带有限公司	外贸销售(浮动底薪年底分红）
深圳市苏泊特科技有限公司	外贸业务员
深圳市宝泉实业有限公司	外贸业务员/B2B / 双休（宝安西乡）
深圳市鸿艺丰精密科技有限公司	日语外贸营业担当
深圳市瑞莱思卫浴产品有限公司	俄语外贸业务员
深圳米格诺科技有限公司	速卖通客服/外贸业务员/纠纷专员
深圳市翼信泰科技有限公司	亚马逊 销售 amazon 运营
深圳傲途乐电子科技有限公司	跨境英语客户服务专员
深圳市易达云科技有限公司	品牌推广主管
深圳市艾锦特电子科技有限公司	亚马逊AMAZON物流专员
深圳攀兴达科技有限公司	亚马逊运营专员 Amazon运营专员
深圳市君盛电子科技有限公司	亚马逊英国站运营/英国站销售
深圳市诺亚创梦电子商务有限公司	Lazada、shopee(虾皮)运营主管
深圳市龙岗区幽沃克斯电子商行	(布吉)亚马逊 销售运营
深圳市马踏飞燕科技有限公司	Amazon销售、亚马逊运营
深圳市顺博绝缘材料制造有限公司	业务助理/业务跟单
深圳创优国际商贸有限公司	亚马逊推广专员/SNS专员
深圳市誉创科技有限责任公司	英文产品编辑/产品文案/产品翻译
深圳市泛科科技有限公司	海外推广
深圳市华平国际货运代理有限公司	货代海外业务员（旅游+弹性工作+高提成）
深圳市捷购快线科技有限公司	亚马逊业务组长 欧美日站点
深圳市德恒顺供应链管理有限公司	巴西仓储葡萄牙语运营专员
深圳市凯瑟瑞贸易有限公司	英语 亚马逊运营专员/Amazon销售(美国  加拿大）
深圳嘉境电子商务有限公司	亚马逊运营专员
深圳市聚荣科技有限公司	亚马逊站外运营专员
深圳桑椹电子商务有限公司	亚马逊运营助理/包吃/应届生/精品
深圳伟艾鹏科技有限公司	阿里巴巴国际站运营推广专员
深圳市上佳汽车维修工具有限公司	跨境电商运营/ebay销售
深圳市优杰瑞电子有限公司	阿里巴巴国际站专员
车大福（深圳）科技有限公司	亚马逊运营
深圳金海智控科技有限公司	业务跟单
深圳市秋稻田实业有限公司	Amazon 亚马逊销售/运营
深圳航龙国际物流有限公司	海运销售
深圳羿龙电子有限公司	财务会计专员/会计文员
深圳凯高现代物流有限公司	东南亚区域销售
深圳市康迪讯科技有限公司	电商品质工程师
深圳市零奔洋光电股份有限公司	国际站运营 /推广/谷歌海外专员
深圳市拓威眼镜实业有限公司	CAD绘图员
深圳市中赢国际物流有限公司	英语助理
深圳飞凡创意科技有限公司	产品开发专员亚马逊（坂田）
深圳创盛百世科技服务有限公司	商务助理文员
深圳市旭淼国际商务有限公司	速卖通运营/亚马逊运营助理
深圳万航进出口贸易有限公司	行政人事主管
深圳市卡利尔实业有限公司	亚马逊销售 精品 提成高
宁海虎狼电器有限公司	亚马逊运营专员
深圳市易思酷尔科技有限公司	亚马逊产品开发
湖南融创致远网络科技有限公司	亚马逊运营总监（奖金+提成）
深圳市澄海能源科技有限公司	Linio运营专员（西班牙语）
深圳市好兄弟航模有限公司	亚马逊运营
深圳市英杰投资有限公司	进口面料跟单
深圳市鑫贝帝科技有限公司	家具开发专员
深圳市爱霖贸易有限公司	Ebay销售
广东电将军能源有限公司	副总裁助理
深圳市天��科技有限公司	亚马逊客户关系专员
顺科国际货运代理（上海）有限公司...	销售助理/销售支持
深圳市康斯德科技有限公司	诚聘销售区域经理
深圳市丰泽国际货运代理有限公司	货运海外业务员
上海倍赋信息科技有限公司深圳分公...	销售代表
深圳市亚声威格科技有限公司	采购专员
深圳唯尚塑胶电子有限公司	Amazon 亚马逊运营专员
东莞市百立文化传播有限公司	高薪诚聘销售顾问
深圳市理邦精密仪器股份有限公司	国际大项目经理
深圳市亚飞电子商务有限公司	亚马逊Amazon意大利语销售
深圳祥龙盈塑胶模具制品有限公司	包装核价计价工程师
深圳市深科信飞电子有限公司	项目经理
深圳市易太思智能科技有限责任公司...	国际业务销售经理
深圳市商聚投智投资有限公司	Amazon运营专员
深圳恒福隆科技有限公司	亚马逊产品开发
深圳市汤姆拓客科技有限公司	亚马逊运营专员（德语）
深圳市赛驰科技有限公司	Amazon英语销售
深圳易创意贸易有限公司	ebay运营专员
深圳磊迈照明科技有限公司	海外销售（智能LED灯具）
深圳市华宇国际认证有限公司	跨境电商销售主管/运营主管
深圳市海川实业股份有限公司	国际业务总监（食品）
深圳睿拓电子有限公司	亚马逊运营（专业八级）
深圳莱能士智能科技有限公司	海外销售
晖欧贸易（深圳）有限公司	业务跟单助理
深圳市爱购网络科技有限公司	ebay销售/ebay运营（海外仓）
深圳市卓豪智能电器发展有限公司	销售代表（包住）
深圳市胜兴旺精密科技有限公司	海外品牌销售
深圳市巨诺电子有限公司	阿里国际站运营专员
深圳市沸典商贸有限公司	采购
深圳市鸿发顺达模具有限公司	应届毕业生
深圳市创晶辉精密塑胶模具有限公司...	运营专员
深圳市诺逸科技有限公司	采购专员
深圳超然科技股份有限公司	国际业务专员（龙岗大运地铁站）
深圳冉益科技有限公司	阿里后台运营
深圳前海一凡科技有限公司	速卖通运营
深圳市华联易购科技有限公司	供应商开发工程师
深圳市创新宝骏数码科技有限公司	亚马逊运营专员/主管
深圳市永盟智能信息系统有限公司	国际贸易
深圳千魅科技有限公司	Amazon运营专员/资深运营大神
深圳三麦国际货运代理有限公司	海外空运销售
深圳市飞森贸易有限公司	阿里巴巴业务员
宁波市鄞州恒石贸易有限公司	跨境电商运营主管 亚马逊
深圳市拓享科技有限公司	LED海外销售工程师
深圳市鑫越贸易有限公司	Ebay销售/运营专员
捷登（深圳）商业保理有限公司	急聘中美贸易海外业务专员
深圳市森�D电子商务有限公司	亚马逊运营（精品）美国  欧洲
深圳市电三原科技有限公司	外贸业务员/外贸销售/外贸精英/外贸专员
深圳市万维莱实业有限公司	亚马逊运营总监/经理
深圳市百橡电子商务有限公司	北美客服专员
深圳邦德光电科技有限公司	亚马逊运营专员
深圳市跨境宝科技有限公司	亚马逊销售
深圳市简车速配科技有限公司	英语助理/速卖通客服/应届生优先
闻泰通讯股份有限公司	高级船务
深圳市晔翔智能科技有限公司	亚马逊销售Amazon运营加拿大（大小周）
深圳市环球致远科技有限公司	EBAY销售专员 ebay运营
深圳市斯特菲科技有限公司	亚马逊运营专员
昭津物流（深圳）有限公司	人力�Y源及行政主任
钰龙海电子（香港）有限公司	销售代表 贸易/销售业务员 助理
深圳市宜兰德科技开发有限公司	亚马逊美工
万宇通国际电子商务深圳有限公司	速卖通客服主管/专员
深圳市全方位国际货运代理有限公司...	销售助理
深圳睿蚁科技有限公司	市场营销经理(业务运营经理）
深圳市炎臻科技有限公司	阿里巴巴国际站运营
深圳市博纳多科技有限公司	精    速卖通运营
深圳乐品星河数据技术有限公司	海外推广高级经理
深圳市速易特科技有限公司	网络客服
深圳市鑫亿宇源科技有限公司	CDiscount运营/法语销售助理
深圳市艾比森光电股份有限公司	国际销售工程师（泰国 英语）(J10295)
深圳市古朴润网络科技有限公司	速卖通运营
深圳市新福朗特精密科技有限公司	业务员(模具)
深圳市天源大地科技有限公司	采购
深圳市木乔电子贸易有限公司	阿里巴巴国际站运营/业务员
深圳市凌度汽车电子有限公司	亚马逊欧洲站运营英语/法语8-12K
深圳市金方华网络技术有限公司	Amazon美国站运营专员
深圳市万唯信贸易有限公司	亚马逊运营专员
深圳市博铭斯电子科技有限公司	华强北（驻店）销售代表
深圳市海博瑞科技有限公司	速卖通运营专员
深圳市捷代电子科技有限公司	电商平台运营
深圳市汇智供应链有限公司	国际货运海外代理销售
深圳贝礼城礼品有限公司	外贸业务员/外贸跟单员/外贸销售主管/外贸经理
深圳市力科信实业有限公司	亚马逊店铺运营
深圳市德利高国际货运代理有限公司...	急聘海运操作
深圳市高仁电子新材料有限公司	海外销售
深圳创译无限实业有限公司	翻译公司项目助理
深圳市曙未科技有限公司	中东亚马逊运营amazon销售
擎天（广州）货运有限公司深圳分公...	资深海外客服
深圳市尔登科技有限公司	亚马逊运营专员
深圳市龙飙物流有限公司	FBA国际物流实习业务员
香港��伟（远东）有限公司深圳代表...	业务跟单
深圳市瑞秋国际物流有限公司	跟单助理包吃住7H工作制
上海奕洲商务咨询有限公司	Junior Product Developement Manager
深圳市原子精密科技有限公司	业务跟单（工程方向）
深圳市零壹创新科技有限公司	英文文案
深圳市名优创品科技有限公司	应届毕业生--站外推广方向
深圳市蒂益嘉科技有限公司	仓库配货员（提供住宿）
深圳市集贝若林有限公司	ebay速卖通专员运营（高提成）
正南电子商务（深圳）有限公司	amazon亚马逊产品开发双休
深圳市鑫宝瑞科技有限公司	B2B网站产品开发/独立站开发
深圳市泰冠鑫科技有限公司	客服文员
深圳尔宸实业有限公司	美工
深圳市尚品荟电子商务有限公司	亚马逊运营助理
深圳市万引力工程技术有限公司	自建网站SEO/SEM网络优化师
深圳市华阳电科贸易有限公司	阿里巴巴国际站销售专员
深圳市百度电子有限公司	阿里巴巴运营
深圳市深联创电子有限公司	亚马逊运营（美国站）
深圳市安德在线商贸有限公司	Ebay销售
深圳市得芯国际商贸有限公司	亚马逊运营主管
深圳市一心一景科技有限公司	亚马逊销售/运营/底薪6K起
深圳市华仁创新科技有限公司	亚马逊销售/Amazon运营专员（精品）
深圳市亿嘉洲国际货运代理有限公司...	市场专员
上海航姆国际船舶代理有限公司深圳...	报关员
深圳市唯利胜科技开发有限公司	亚马逊精品销售/运营（可接受应届生）
深圳市东晟嘉供应链有限公司	货代业务员
深圳市海通融科实业有限公司	亚马逊运营主管（急聘，双休，高薪）
深圳市优耐检测技术有限公司	EMC报告文员-应届毕业生
深圳卓乐电子商务有限公司	亚马逊销售主管/亚马逊运营主管/亚马逊
深圳市鑫顺源国际物流有限公司	总经理助理（周末双休）
深圳市格朗电器有限公司	亚马逊运营
深圳市捷锐泓电子有限公司	跨境电商客服
深圳市沃源科技有限公司	阿里巴巴国际站运营
深圳市天成电子贸易有限公司	亚马逊运营Amazon销售
深圳市道耐科技有限公司	商务主管
深圳市乔恩斯科技有限公司	Ebay销售 Ebay主管 德国站点
深圳市乐途乐科技有限公司	跨境电商运营专员
深圳市宝嘉昆娜时尚有限公司	会计
亿柏国际科技(深圳)有限公司	采购经理
深圳市南美健康管理咨询有限公司	招商经理
深圳市博琨贸易有限公司	亚马逊 Amazon 产品开发
深圳胜泰电容器有限公司	销售专员
地中海捷运物流（上海）有限公司	海空运操作员
深圳市仙芙妮科技有限公司	物流业务员（海外经验优先）
深圳市鑫隆源信息科技有限公司	电话销售/网络销售/双休
爱乐福（深圳）科技有限公司	应届毕业生
深圳市嘉新科技有限公司	亚马逊美工
深圳市鸿月盛科技有限公司	亚马逊销售--应届毕业生
毅丰显示科技（深圳）有限公司	售后客服专员(年度旅游、体检等福利)
史泰博品牌咨询（深圳）有限公司	Product Development and Sourcing Specialist
深圳市威联国际供应链有限公司	电商产品开发
深圳店管家软件有限公司	在线客服/网络淘宝客服（晋升空间）
深圳市俊牛电子有限公司	Amazon业务助理亚马逊业务助理
深圳市�辉么缶频旯芾碛邢薰�司	商务专员
深圳市中扬数控机床有限公司	海外市场部销售经理
深圳乐为特电器有限公司	Google SEO 优化师
如品文化传媒（北京）有限公司	电话销售
深圳市洛奇商贸有限公司	电商助理
深圳市旭挺模具科技有限公司	电商产品开发（淘宝/阿里巴巴）
深圳市卓达电子有限公司	跨境电商会计
深圳雷特网络科技有限公司	EDM邮箱营销专员
深圳市皓腾企业管理顾问有限公司	会计实习生
深圳市优速易供应链有限公司	电商物流专员/助理
深圳市彩悦科技有限公司	亚马逊销售
深圳前海安华供应链有限公司	物流助理/专员
深圳市晨和智能有限公司	业务跟单助理(应届毕业生）
深圳市新科盈数码有限公司	亚马逊运营主管
深圳兴皇玛科技有限公司	Amazon亚马逊运营 亚马逊销售
天煦电子有限公司	亚马逊运营专员 外贸销售 业务 电商业务员
深圳市同语科技有限公司	急聘 Amazon/亚马逊运营专员
深圳市图拉斯科技有限公司	亚马逊运营专员（德国站）
深圳市平安假日国际旅行社有限公司...	线上客服
深圳市通亚照明科技有限公司	亚马逊运营专员
深圳市太阳石能源科技有限责任公司...	B2C销售 eBay专员
深圳丰泰达电子有限公司	阿里巴巴国际站运营
深圳市中广电通灯业有限公司	业务跟单
深圳市高宇星贸易有限公司	ebay产品开发
深圳市星球实业有限公司	阿里巴巴后台运营专员
深圳市康斯达尔科技有限公司	采购员 电商采购
深圳市巡洋国际物流有限公司	货代空运文件 /操作/跟单/单证
深圳市美而佳科技有限公司	亚马逊英语销售UK站
深圳阿拉丁灯光科技有限公司	亚马逊运营专员
深圳市久比科技有限公司	Finance Manager/ Accounting Manager
深圳市智联电器有限公司	亚马逊运营专员
深圳市小贝壳实业有限公司	亚马孙运营
深圳市德龙伟业创新科技有限公司	电机销售
光越科技（深圳）有限公司	海外销售
南京联安供应链有限公司	客户经理
深圳市创生达电子有限公司	业务总监
香港捷购电子商务有限公司	销售代表
深圳市嘉美顺贸易有限公司	亚马逊日本站运营助理 （欢迎应届生）
深圳市惠德贵科技开发有限公司	亚马逊销售运营
深圳市鼎达富国际货运代理有限公司...	货运代理
深圳市聚盛智能科技有限公司	智能手表/手环销售经理
深圳市卓远通货运代理有限公司	销售代表/急招高薪
深圳万世信息网络有限公司	西班牙运营助理
深圳市同乐安防设备有限公司	速卖通销售速卖通业务速卖通运营
深圳市金盟友机电科技有限公司	精密冲压业务担当员
深圳市兴凯顺科技有限公司	亚马逊商务经理
深圳市创鑫宏科技有限公司	产品开发/无经验要求
深圳市云鑫利科技有限公司	网站推广/ 网站SEO推广/ 网站运营推广
深圳市瑞沃德生命科技有限公司	海外销售工程师（欧洲大区）
深圳市中运恒供应链管理有限公司	渠道业务员
深圳市嘉士格科技有限公司	财务/会计
深圳市安飒诺科技有限公司	亚马逊销售
深圳市捷美达国际货运代理有限公司...	高薪急聘销售助理
深圳市尚狼科技有限公司	速卖通运营专员
深圳市库玉玛创新科技有限公司	急聘亚马逊运营组长（日本站）
云淘国际供应链管理（深圳）有限公...	货代业务员（报关与货运专业应届生）
斯帝夫金（上海）包装材料有限公司...	项目经理
深圳丽兹行房地产投资顾问有限公司...	房地产销售/客户经理/高底薪
深圳市福硕光电科技有限公司	跟单文员/业务跟单员
深圳市峰霖光通信有限公司	阿里巴巴国际站运营专员
深圳市雅琪光电有限公司	业务跟单
深圳市佰瑞特紧固件有限公司	亚马逊运行专员
泉芯电子技术（深圳）有限公司	销售助理
深圳市可立骐贸易有限公司	亚马逊德国站
深圳市爱品购网络科技有限公司	eBay产品开发
深圳市好易视科技有限公司	人事行政专员
深圳市金合光电科技有限公司	国际贸易经理/主管
深圳市高吉尔斯电子科技有限公司	吃鸡游戏测试实习员双休五险一金
深圳市南岸电子商务有限公司	急聘日语翻译 包住
深圳高科特科技有限公司	国内销售
深圳市捷利力霸国际货运代理有限公...	国际货运代理业务/销售
深圳市万方国际货运代理有限公司	海运操作
深圳市众志达电子有限公司	日语翻译
深圳市赛为智能股份有限公司	进出口财务专员
深圳市帕乐厨房设备有限公司	国际贸易专员
深圳市汇诚电子商务有限公司	ebay组长
深圳市美宝来科技有限公司	Amazon亚马逊运营（欧洲站）
深圳市波特城投资管理有限公司	高级营销经理（IPO方向）
深圳市亿�隹萍加邢薰�司	亚马逊运营专员销售-龙华
深圳市淘英贸易有限责任公司	亚马逊美国站运营招聘（高底薪+高提成）
深圳市昊泰衡科技有限责任公司	亚马逊财务总监
深圳市职岛科技有限公司	跨境电商运营专员+宝安
深圳市新起点光电有限公司	应届毕业生（英语六级）
深圳市网际奔跑者贸易有限公司	亚马逊运营/电商销售/Amazon助理
深圳东联电子商务有限公司	亚马逊销售主管/运营主管
深圳市领欧网络科技有限公司	网站维护/推广
深圳市威联特电子有限公司	亚马逊运营专员/销售--汽车配件类目
深圳市顶兴电子商务有限公司	跨境电商财务
深圳市启德电子商务供应链管理有限...	客户代表
深新纺织实业（深圳）有限公司	英文跟单助理
深圳市台智伟业电子有限公司	阿里巴巴国际站运营
库勒照明（深圳）有限公司	外贸跟单/ 业务员/大客户经理
深圳视爵光电有限公司	阿里巴巴国际站运营
深圳市卡帝德塑料制品有限公司	阿里巴巴国际站运营
深圳市格先者科技有限公司	阿里巴巴国际站运营
深圳市芯朗科技有限公司	速卖通销售/外贸销售
深圳市恒同鑫科技有限公司	龙岗包住外贸业务员专员销售助理
深圳市迪科光通信有限公司	外贸销售经理
深圳威斯康科技有限公司	外贸业务员 / 急聘
深圳市中新力电子科技有限公司	外贸业务员\外贸主管\外贸销售
金上晋科技（深圳）有限公司	外贸助理
深圳市永顺康电子科技有限公司	外贸业务员（双休）
深圳市和立创远科技有限公司	采购专员 外贸采购 无经验要求 带薪培训
深圳市科源泰实业有限公司	年薪20万-40万外贸业务国际销售
深圳市朗科智能电气股份有限公司	外贸业务员(电子类)
深圳市雅鲁实业有限公司	外贸业务员
深圳市德尔电子有限公司	外贸业务员
深圳市中光光电有限公司	外贸业务员
深圳市金九天视实业有限公司	外贸经理
深圳市高斯宝电气技术有限公司	外贸业务
深圳市永联泰胶袋制品有限公司	外贸销售
深圳市铠沃科技有限公司	外贸业务（应届生）
深圳市中科源电子有限公司	外贸跟单（接收应届毕业生）
深圳市健宏科技有限公司	外贸业务员
深圳市越达彩印科技有限公司	急招  外贸跟单（可接受应届生 五险一金
东莞�霭菜芙耗＞哂邢薰�司	外贸业务
深圳远东卓越科技有限公司	外贸业务员
东莞市力星激光科技有限公司深圳分...	外贸经理
湖南谐振电子有限公司	外贸业务员
深圳慧新辰技术有限公司	外贸专员
深圳市敬业辅料供应链有限公司	B2B外贸业务员
深圳市浩景丰实业发展有限公司	外贸业务员(底薪5K+高提成+客户资源)
深圳市易联达商用设备有限公司	外贸业务员（急聘 、包住宿）
深圳市连胜技术有限公司	阿里巴巴国际站运营外贸业务员
深圳市维嘉斯特科技有限公司	外贸专员
深圳市联运达电子有限公司	外贸业务员/外贸销售代表/外贸业务
深圳市神州线缆有限公司	外贸专员，外贸销售、海外销售
深圳市摩记电子有限公司	外贸业务
深圳邦博古德科技有限公司	外贸业务助理
深圳市艾布瑞斯科技有限公司	外贸跟单/跟单文员/跟单员
深圳市晟瑞科技有限公司	外贸/贸易专员/助理
深圳市新添润彩印机械设备有限公司...	外贸专员
深圳市易腾拓科技有限公司	亚马逊西班牙语外贸业务员/跨境电商
深圳市卡蒂娜贸易有限公司	底薪3.8k起+高提成急聘B2C外贸业务员应届毕业生
深圳特龙卡电子有限公司	电商外贸运营
深圳市思研鑫科技有限公司	B2B外贸业务
深圳市时代精密塑胶模具有限公司	外贸业务员
深圳�D飞科技有限公司	跨境电商运营  B2C外贸    电商运营专员
深圳市鹏锦科技有限公司	外贸业务员（包住+包吃）
深圳海洲汇科技有限公司	亚马逊美工/外贸电商美工
深圳七彩虹灯饰有限公司	外贸业务
深圳市亿徕尔科技有限公司	外贸专员（5K+高提成+包住）
深圳市罗优精密电子有限公司	高薪-急聘外贸业务员
深圳市凯尔沃科技有限公司	外贸员-外贸主管-外贸精英+高提成
深圳市烁立方科技有限公司	速卖通外贸销售
深圳宏安通信科技有限公司	外贸业务员(双休）
深圳市照阳智汇电子科技有限公司	外贸业务员/国际销售（出国机会，国外展会）
深圳市东方杰佳电子有限公司	外贸业务员包住，社保，年终奖
深圳市聚鸿互联技术有限公司	外贸经理/外贸负责人/外贸合伙人
深圳市创美佳精品制造有限公司	蓝牙耳机外贸员（急聘）
深圳市宏力捷电子有限公司	英语外贸业务员
深圳市腾森家庭用品有限公司	外贸业务助理
深圳市青青子木科技有限公司	资深外贸 海外市场总监 南山上班
深圳市晟诗途实业有限公司	Ebay外贸客服+社保
深圳市艾维普思科技有限公司	外贸助理
深圳市安瑞创电子科技有限公司	资深外贸业务员（双休.急招）
深圳市镁源科技有限公司	南联地铁站附近招聘外贸业务员
深圳市云顶迅销科贸有限公司	外贸推广
深圳市拓普达科技有限公司	外贸销售
深圳市领航卫士安全技术有限公司	外贸专员/外贸业务员/海外销售
深圳市宜博时尚科技有限公司	外贸助理
深圳市广明光电科技有限公司	外贸销售业务员
深圳市军恩伟业科技有限公司	优秀应届毕业生-外贸客服
深圳市信易科技有限公司	B2B外贸业务员 （丰厚收入+双休）
深圳市欧博迪通信有限公司	高薪外贸业务员(出国机会+期权)
深圳市斯汉德科技有限公司	外贸业务员（大小周，包住，欢迎应届毕业生）
深圳市鑫勤丰工业设备有限公司	外贸/贸易专员/助理
深圳市拓琦光电科技有限公司	外贸业务经理
深圳市芸丰泽电子有限公司	外贸销售专员
遂川亚恒电路有限公司	外贸业务员
九辉包装（深圳）有限公司	外贸主管
方纳企业管理咨询（广州）有限公司...	外贸经理
深圳市摩卡普科技有限公司	外贸业务员（实习岗）
浙江伟星实业发展股份有限公司	外贸员（深圳）
深圳市益达兴科技股份有限公司	外贸主管
深圳市讴鸟科技有限公司	外贸业务专员（高底薪+高提成+年终奖）
深圳市十年科技有限公司	外贸业务员
深圳市享往科技有限公司	外贸业务员
深圳市金地利服装进出口有限公司	外贸专员
深圳宝童乐园实业有限公司	急聘-箱包外贸业务
深圳市雅韵坦工程有限公司	外贸跟单员（双休）
苏美达国际技术贸易有限公司	外贸经理（铁矿石进口）
深圳市奋达科技股份有限公司	外贸业务代表
深圳市光纤城通讯有限公司	外贸销售经理
深圳市旭澜卡科技有限公司	外贸业务员---- 日语
深圳市百乐富电子科技有限公司	外贸业务员 外贸销售 宝安 双休 高提成
深圳市联域光电有限公司	外贸业务员
深圳市恒玮科技有限公司	外贸专员
深圳市友亿成智能照明股份有限公司...	LED外贸业务员
深圳市腾达兴电子有限公司	外贸业务员
深圳市博佳玩具有限公司	外贸跟单员
远通五金塑胶制品(深圳)有限公司	印刷外贸跟单
深圳亿宣科技有限公司	外贸业务专员
深圳市倍德文具有限公司	外贸专员
红品晶英科技（深圳）有限公司	日语外贸跟单员/大小周/包吃住
深圳市昭洋网络有限公司	急聘外贸客服
深圳市润通电声科技有限公司	外贸业务员/跟单员
德瑞姆创新科技（深圳）有限公司	外贸业务员/英语外贸业务员
深圳市米瓦智能科技有限公司	外贸业务员
深圳市新高品体育用品有限公司	外贸跟单员
深圳市光热科技有限公司	外贸网站运营/网站推广 SEO
深圳市科汇兴科技有限公司	外贸业务员
深圳市鼎付优达科技服务有限公司	外贸销售（双休）
深圳市卡西威尔科技有限公司	外贸业务员/外贸销售/外贸专员
深圳市艾佳创想科技发展有限公司	外贸助理/外贸专员
深圳帝视盾科技有限公司	外贸业务员（Alibaba）
深圳市显胜光电科技有限公司	B2B外贸销售代表
深圳市祺鑫创展科技有限公司	eBay运营 eBay销售 外贸业务员
深圳大洋特种玻璃有限公司	外贸跟单员
深圳市纽斯威科技有限公司	外贸业务（5K-8K）
深圳市佳缘美包装工艺有限公司	外贸专员
深圳市贵禾有机玻璃制品有限公司	外贸运营
深圳市盛泰达电子有限公司	外贸助理
深圳尚族精锐科技有限公司	外贸跟单员
深圳市佰瑞纳贸易有限公司	外贸业务员/B2B外贸销售/外贸专员/双休
拓维展示制作（深圳）有限公司	五险+绩效奖金+外贸业务员
深圳市永威达智能科技有限公司	高级外贸业务员/阿里巴巴国际站运营
深圳市华泽兴业科技有限公司	外贸跟单员
深圳市博实实业有限公司	外贸业务员
深圳市华盛翔通信技术有限公司	外贸经理
深圳市西凯照明科技有限公司	外贸业务员
深圳市置辰海信科技有限公司	外贸专员
深圳纷客科技有限公司	外贸跟单员
深圳市桑泰防伪材料有限公司	外贸跟单员
深圳市环思拓物流有限公司	外贸业务员/外贸销售
深圳拓网科技有限公司	外贸经理
深圳市国琰箱包有限公司	外贸经理
昌宁德康生物科技（深圳）有限公司...	外贸跟单员
深圳市东峰盛科技有限公司	外贸经理/主管
深圳市庭锋五金制品有限公司	外贸业务跟单
深圳市绿壹科技有限公司	阿里巴巴外贸业务员（底薪+提成，带薪休假）
深圳市锦鸿泰科技有限公司	外贸运营总监
深圳市博威创新技术有限公司	外贸销售、外贸业务员
深圳市酷凌时代科技有限公司	外贸业务员/高薪实习
深圳市德尔凯科技有限公司	外贸助理
香港芯中心科技有限公司	外贸专员/外贸业务员
ZHONGHE HEADWAY BIO-SCI&TECH CO...	外贸业务员
深圳市金顺印刷有限公司	外贸业务员（5K+社保）
深圳市威斯特浦科技有限公司	外贸专员
深圳市拓安科技有限公司	外贸业务员
深圳市科帕奇科技有限公司	eBay专员/外贸业务员/5K+
深圳市鑫睿铭科技有限公司	外贸业务员 销售（双休+午餐）
深圳市兴海鹰国际贸易有限公司	急聘eBay客服/英语客服/外贸客服
深圳前海安迈格科技有限公司	外贸全网营销专员
深圳市凌云胜达科技有限公司	Amazon亚马逊外贸销售  亚马逊销售专员 亚马逊业务员
深圳市爱美家电子科技有限公司	外贸助理
深圳市锐傲视讯有限公司	外贸业务员（高底薪+高提成）
力达铝业（深圳）有限公司	外贸经理
阳华数码科技（深圳）有限公司	外贸业务员
深圳市凇江科技有限公司	外贸业务员
深圳鸿发自动门有限公司	急+龙岗+外贸业务员+包吃住
深圳市科宇龙科技有限公司	外贸销售
深圳市拓威技术服务有限公司	外贸跟单员(急招）
深圳瑞光康泰科技有限公司	外贸业务员
深圳市恒天伟焱科技有限公司	外贸跟单员
深圳市欧美欧科技有限公司	外贸助理/外贸业务员
深圳市苏博尔思科技有限公司	LED外贸业务员
深圳顺黄纸品有限公司	外贸跟单
深圳市森盟科技有限公司	外贸业务经理
深圳市沃利源科技有限公司	资深外贸业务员
深圳市诚鑫旺科技有限公司	外贸销售助理、外贸跟单文员
易达科技（深圳）有限公司	外贸业务（双休+住宿）
深圳市绿明光世界科技有限公司	外贸经理/外贸主管/高级外贸/LED照明
深圳市永强富实业有限公司	外贸业务
深圳奇辉模具塑胶有限公司	外贸业务员
深圳市兰蒂斯科技有限公司	外贸跟单员
深圳市恒讯通达科技有限公司	外贸业务员
前海大同（深圳）智能科技有限公司...	外贸业务员
深圳市新锐标牌科技有限公司	外贸专员
深圳市迈凯诺电气有限公司	外贸助理可接受应届毕业生）
深圳市锐创力科技有限公司	外贸销售 外贸业务员
深圳市恒瑞照明科技有限公司	外贸专员
深圳市迈拓电子有限公司	外贸业务员
深圳市中检南方检测有限公司	外贸跟单+双休+双地铁口+优福利
深圳华域佳泰纺织科技有限公司	外贸销售总监
深圳市宝圳科技有限公司	俄语外贸业务员（高薪急聘）
聚银塑料包装制品（深圳）有限公司...	外贸业务员
深圳市海纳时代电子有限公司	急聘外贸业务员（无责底薪+提成+绩效奖金）
信诺电子科技有限公司	外贸销售
深圳市莱帝森环保节能科技有限公司...	外贸业务员
深圳市科莱德电子有限公司	外贸经理
深圳市环誉贸易有限公司	外贸部文员
深圳市品海电子商务有限公司	外贸电商服装采购主管
深圳市三易网络科技有限公司	外贸采购助理
深圳市四季发展实业有限公司	外贸业务员-美容仪器
深圳市大德兴精密模型设计有限公司...	外贸业务员
江西鼎�N家居有限公司	外贸专员
深圳市拓普环球科技有限公司	外贸业务员
深圳市欧盛创宇电子有限公司	外贸业务员
深圳市思肯达科技有限公司	外贸业务员助理 应届毕业生
深圳市映楚科技有限公司	Ebay销售,外贸业务员
深圳市承越创展科技有限公司	外贸业务员
深圳市旭滔电子有限公司	外贸业务员
深圳市欧士照明科技有限公司	外贸业务员
深圳梅斯进出口有限公司	Ebay客服 外贸客服 Amazon专员 英语客服
深圳迈朴森科技有限公司	应届毕业生/外贸业务员
深圳市海骏鑫电子科技有限公司	外贸业务跟单
深圳市捷能星光电科技有限公司	外贸业务总监
深圳市魅科贸易有限公司	外贸专员
深圳市百思勤工贸有限公司	外贸销售/亚马逊销售（龙岗区地铁旁，5天半，不出差）
深圳市国兴达科技有限公司	外贸业务员/国外销售代表/高提成
深圳市德美科精密技术有限公司	外贸业务助理
深圳市顺兴声电子有限公司	外贸业务员
深圳市宝欣元科技有限公司	外贸主管
深圳市广信义电子有限公司	招外贸业务月薪过万
深圳市一光年创新科技有限公司	外贸销售（日韩俄南美市场）
深圳市雷摩电子有限公司	外贸销售
深圳龙腾电器科技有限公司	速卖通客服/外贸客服/英语客服
北京远大创新科技有限公司	国际贸易专员
深圳市泛亚物流有限公司	业务跟单
深圳福凯半导体技术股份有限公司	业务跟单
深圳市净果电子商务有限公司	网络销售专员，电子商务专员，网络销售代表月均8000元
深圳市新天地国际物流有限公司	海空运操作专员/主管
深圳市隆鑫达金融服务有限公司	抵押贷款销售专员
UL中国	跟单文员
深圳市广联亚国际贸易有限公司	海运销售（双休海外游）
深圳市迈测科技股份有限公司	国际销售
深圳市银星智能科技股份有限公司	外销部部门助理
深圳市亚米拉电子科技有限公司	2.4G、蓝牙键盘方案及成品业务员
华德新中威咨询服务（深圳）有限公...	INTERNSHIP PROGRAM 实习生
深圳市亚辉龙生物科技股份有限公司...	出口商务专员
深圳市优克联新技术有限公司	海外销售经理
中欧快铁国际运输（深圳）有限公司...	诚聘国际销售精英
艾普拉斯投资顾问（北京）有限公司...	平台运营总监（操盘手）-跨境电商
麦迪实电子科技（深圳）有限公司	英文跟单
深圳大鹏鸟电子有限公司	Ebay运营/跨境电商
深圳市飞驴科技有限公司	亚马逊销售
上海盛本智能科技股份有限公司	智能POS海外销售经理
深圳市生活本色实业有限公司	进口采购专员
普及尤提乐机电（深圳）有限公司	海外采购助理
深圳世俊投资发展有限公司	买手设计师
新蕾科技集团	商务专员
深圳市熙人实业发展有限公司	异域产品电商平台筹备负责人
深圳市优迈灯饰有限公司	亚马逊运营主管
上海乐高船务有限公司深圳分公司	海运客服
深圳市古古美美实业有限公司	亚马逊销售助理
深圳市迪科国际货运代理有限公司	海外客服
深圳鸿泽自动化科技有限公司	会计助理
深圳市利航达国际货运代理有限公司...	海外销售
深圳市三合创贸易有限公司	亚马逊运营经理
深圳优米智能科技有限公司	亚马逊日语运营
深圳市米诺数码配件开发有限公司	高级亚马逊运营主管
深圳市中天安驰有限责任公司	海外销售经理
深圳江铜融资租赁有限公司	税务会计
敦煌印刷（深圳）有限公司	业务跟单
深圳市中世兰科技有限公司	国内业务员/1688业务业务员
深圳市翌睿电子商务有限公司	Lazada运营
深圳市赛尔贝尔智能科技有限公司	亚马逊运营主管/经理
深圳市博耀新材料有限公司	财务专员
深圳市酷乐活科技有限公司	速卖通运营 / 销售
深圳市普众通信技术有限公司	海外销售经理
深圳远捷科技有限公司	高薪诚聘亚马逊欧洲站销售
深圳市湘凡科技有限公司	产品经理(视频方向)
富士康科技集团CMBU	客服工程师
深圳奥景源科技有限公司	海外商务
华网星科技有限公司	Google优化师
深圳市易达恒通供应链管理有限公司...	货运司机兼仓库管理
深圳市荣兴安信科技有限公司	亚马逊销售 Amazon运营专员
东莞市环航进出口贸易有限公司	销售代表
前海极智佳物流（深圳）有限公司	海外市场拓展经理
深圳市全球联运国际物流有限公司	海外业务
万互技术管理（深圳）有限公司	产品开发主管
深圳市大川国际货运代理有限公司	海外操作
深圳市百佳创展科技有限公司	亚马逊运营主管（3c类目）
深圳市前海优为科技有限公司	亚马逊运营专员
中建投商贸有限公司	商务专员
路易士通电子（深圳）有限公司	高级销售工程师
深圳海山供应链科技有限责任公司	（急招）产品开发
深圳市荣之昌电子科技有限公司	亚马逊客服专员 （日本站）
深圳盛业敦豪金链商业保理股份有限...	财务会计
深圳市超宝实业有限公司	采购订单专员/采购跟单（国外）
全球企业管理咨询（深圳）有限公司...	营业担当&amp;业务  深圳光明新区
深圳市康士柏实业有限公司	海外销售经理（亚洲区）
深圳市埃微信息技术有限公司	海外销售经理
深圳市康成泰实业有限公司	高级业务跟单（日语）
深圳市一科时代科技发展有限公司	商务经理
华展鑫荣国际招标代理（北京）有限...	文员
特易行国际货运代理（深圳）有限公...	海外客服
重庆麦一科技有限公司	产品开发经理（重庆）
深圳市埃帝诗钟表有限公司	速卖通专员/有货
卓志供应链集团	物流销售
龙基服装（深圳）有限公司	跟单
拓加电子商务（深圳）有限公司	独立站产品开发
深圳市蓝海供应链股份有限公司	海外销售代表
深圳市扬城工贸有限公司	日语跟单/业务
深圳协同管理咨询有限公司	人事行政经理
深圳市方格尔科技有限公司	海外销售经理
深圳市青马技术有限公司	船务/单证员/物流员
深圳市东美测量仪器有限公司	阿里巴巴国际站运营
�v富百胜宝电器（深圳）有限公司	项目经理/助理（英语）
广东博迈医疗器械有限公司	商务专员（英语）
深圳市肯泰精密科技有限公司	亚马逊运营专员
深圳海油工程水下技术有限公司	进出口专员
TCL华瑞照明科技（惠州）有限公司	LED灯具海外业务经理
深圳市腾逊展翼科技有限公司	德语/法语/双休（经验不限）
佛山光寰贸易有限公司	Merchandiser 客户跟单
新利亚时装（深圳）有限公司	高级英文跟单员
深圳市七叶荟科技有限公司	亚马逊（日本站）运营专员
宝礼行贸易（上海）有限公司 Poly...	采购经理 Sourcing Manager (Stationary and Writing)
深圳市华普德科技有限公司	国外业务跟单 外贸销售 外贸业务 外贸业务助理 跟单员
深圳万邦优佳电子商务有限公司	亚马逊运营专员 美国 欧洲 日本
深圳市富诚达科技有限公司	交管（业务跟单）
上海优吾企业管理咨询有限公司	跨境物流解决方案总监
沈阳亚诗达科技有限公司	外语翻译员（英日俄韩德）
深圳市万宁国际货运代理有限公司	熟手海外销售代表
深圳市全民盛电子有限公司	阿里巴巴国际站运营
深圳市赛铂科技有限公司	亚马逊运营
深圳市撼音科技有限公司	产品经理
深圳市开源通信有限公司	商务助理/应届毕业生
深圳市勤天翊电子有限公司	亚马逊销售
深圳环球良品电子有限公司	亚马逊运营专员（应届生亦可）
深圳市吉斯达货运代理有限公司	操作客服
凯创电子国际有限公司	海外销售（IC电子元器件）
广州合利宝支付科技有限公司	销售经理（跨境支付-深圳）
格林美股份有限公司	采购助理
东莞市瑞铂涵实业有限公司	国际贸易采购经理
合鹄科技（深圳）有限公司	海外推广（五险一金+双休）
美达喜威纺织（深圳）有限公司	面料销售经理
环塑集团	贸易员
广州拓威天海国际物流有限公司	物流销售
深圳市递四方速递有限公司	物流客服（KA方向）
深圳市大协国际货运代理有限公司	国际空海运海外业务
祥兴家居用品（深圳）有限公司	Marketing Assistant
深圳市五福源商贸有限公司	进出口专员
深圳市美易邮科技有限公司	高薪-网易邮箱电话销售
深圳市鸿飞机电科技有限公司	外贸业务/外贸/贸易专员/助理
深圳市华之鑫自动化设备有限公司	阿里巴巴国际站业务
深圳市科达利实业股份有限公司	海外销售经理
赛诺伊信息咨询（深圳）有限公司	Senior Customer Service 英语客服代表
深圳市大族机器人有限公司	海外销售工程师
多美玩具（深圳）有限公司	模具控制部文员（知名外企）
深圳市爱都科技有限公司	阿里巴巴国际站/亚马逊运营
深圳风行社文化传播有限公司	亚马逊AMZON运营专员
深圳百灵声学有限公司	亚马逊/EBAY运营专员
菲鹏生物股份有限公司	拉美国际销售
深圳戴普森新能源技术有限公司	商务销售专员
深圳市鼎盛精密工业有限公司	市场业务经理/助理
东莞市出海服饰有限公司	亚马逊销售主管
连云港满航国际货代有限公司	合作人
顺圆弘通物流集团有限公司	高薪急聘货代业务
盛开时尚家居(深圳)有限公司	财务会计专员
深圳明烁人力资源管理有限公司	市场开发
上海御堂达物流有限公司	海运操作/货运代理/货代
深圳艾维迪泰生物科技有限公司	销售实习生
深圳市新现代商业有限公司	德语翻译
深圳市麦趣科技有限公司	会计/财务/统计员
广州奥昆食品有限公司	越南语业务经理
深圳欧其诺酒业有限公司	国外采购助理
无限光通讯（深圳）有限公司	应届毕业生
深圳市邮讯通电子发展有限公司	商务文员
深圳优丽斯电子商务有限公司	亚马逊运营专员
深圳市光米光电有限公司	亚马逊销售
深圳市飞强货运代理有限公司	物流操作员
河南瑞贝卡发制品股份有限公司	自建站运营经理/独立站运营总监
深圳市筋斗云技术有限公司	亚马逊产品开发
三斑尼贸易（深圳）有限公司	网络销售专员
上海芮铂阅容商贸有限公司	区域销售经理
深圳锐特威斯科技有限公司	财务会计专员
深圳市柔宇科技有限公司	高级商务拓展经理（日本市场）
康誉国际货运代理（深圳）有限公司...	海运 空运业务员
深圳裕荣商业服务有限公司	助理项目经理
香港易立电子有限公司深圳代表处	物流跟单
华煜伞业有限公司	外贸业务员（五险，月薪4k+）
深圳市鑫宇晟科技有限公司	外贸业务员/业务主管（工作地点：车公庙）
深圳同兴兴业美工刀具有限公司	外贸/贸易主管
深圳市欧亚科工贸有限公司	Merchandiser 外贸跟单
深圳市因特路通信有限公司	外贸专员
深圳市新威泰电子科技有限公司	外贸销售专员
深圳市晶科辉电子有限公司	日语外贸业务员
深圳市明汕翻译有限公司	外贸业务员
深圳市正品之源电子有限公司	IC外贸销售
深圳市仪�N科技有限公司	外贸经理
深圳市华屹普科技有限公司	国际外贸业务员
深圳市明之源科技有限公司	led外贸业务员
深圳市驰兴科技有限公司	外贸业务员（超高提成，CET六级或以上）
深圳市洪瑞光祥电子技术有限公司	外贸业务员（月薪8-15K)
深圳市森威尔科技开发股份有限公司...	外贸业务员（美国市场）
深圳市畅联云天科技有限公司	外贸跨境电商运营助理  (应届毕业生）
深圳市益高通科技实业有限公司	外贸业务员（底薪4k-5k+高提成+五险+年终奖）
深圳市鑫绿铭光电科技有限公司	外贸业务员（双休+高提成）
深圳市酷客尚品科技有限公司	外贸销售精英、外贸专员（底薪+提成+5险+大小周）
深圳市唯博易科技有限公司	外贸业务员/ JAC辅导企业
深圳市创世财电子有限公司	外贸业务员/外贸销售（急聘）
深圳市永而佳电子有限公司	外贸专员
深圳市盛锐源电子有限公司	外贸跟单员
深圳市平豪电子有限公司	外贸跟单员
深圳市台源电子有限公司	诚聘外贸销售员
达文恒业科技（深圳）有限公司	外贸业务员
深圳市赫尔诺电子技术有限公司	外贸经理/外贸销售
深圳市图碧环境科技有限公司	外贸业务员（应届生）
深圳市鑫网通科技有限公司	外贸业务员（周末双休有无经验均可）
深圳市集途科技有限公司	外贸ebay/amazon客服/英语客服
深圳市商富电子有限公司	外贸业务员
深圳市百尔威新能源技术有限公司	外贸平台推广专员
深圳市天创展示品有限公司	高薪聘请外贸业务专员
深圳市天一泓电讯有限公司	外贸业务员（应届毕业生）
深圳市天成照明有限公司	外贸专员包吃住
深圳市雷克演出器材有限公司	B2B外贸业务员/阿里巴巴
江苏玉玲珑珠宝科技有限公司	外贸业务员
深圳市骏辉诚博电子科技有限公司	外贸业务员
深圳市遥尔泰科技发展有限公司	外贸业务员 急聘
深圳市零一零一科技有限公司	外贸业务员
深圳市小义智能科技有限公司	外贸实习生
深圳市伟思顿电子电器有限公司	高薪诚聘  外贸业务
深圳市远邦进出口有限公司	外贸跟单员
深圳爱非科医疗科技有限公司	外贸经理
深圳市金源浩进出口有限公司	外贸经理
深圳市乐乐多科技有限公司	阿里巴巴国际站外贸业务员B2B
深圳市园科园林绿化有限公司	外贸业务跟单 包吃住+底薪+提成
深圳市煜诚国际货运代理有限公司	外贸经理/高提成
海林电脑科技（深圳）有限公司	外贸业务助理
深圳美众联科技有限公司	外贸业务员/国外销售
深圳市聚鑫创时科技有限公司	亚马逊助理/外贸助理
深圳辛孚优生活科技有限公司	外贸销售
深圳市彩易达光电有限公司	外贸业务/精英
深圳市博视达光学仪器有限公司	紧缺外贸人员--之前的都当老板去了
深圳市欧兰特智能控制系统有限公司...	外贸业务员
深圳市普晟经贸有限公司	外贸专员/高薪急聘/双休
深圳云之彩美术工艺用品有限公司	外贸助理
深圳市浩文安通科技有限公司	外贸业务员(月薪8000+)
深圳市比比尔照明有限公司	外贸业务员（LED）
深圳市鑫聚慧有限公司	外贸客服/速卖通/eBay英语客服/英语应届生
深圳市罡扇广联电子科技有限公司	俄语外贸业务员
深圳市生动运动用品有限公司	外贸经理
深圳市瑞孚科技有限公司	外贸业务员
深圳市法尼斯特科技有限公司	外贸业务员 5K+ 包吃住
迪实科技（深圳）有限公司	外贸业务员
深圳市光极通信技术有限公司	外贸跟单 外贸助理
深圳普瑞玛建材有限公司	国际外贸业务员/外贸业务员
深圳市承明科技有限公司	外贸业务员 高薪高提成
深圳市可乐发礼品有限公司	日语外贸业务员
深圳市贸趣网络科技股份有限公司	（急聘 ）外贸专员（周末双休+年假）
深圳市康利邦科技有限公司	外贸经理
深圳艾默仪具有限公司	跨境电商外贸销售运营/速卖通/亚马逊/ebay
深圳市赛尔美电子科技有限公司	外贸业务员
特大纺织制品（深圳）有限公司	外贸业务员 International Sales
深圳市伟力创精密五金有限公司	数控五金外贸业务员
深圳市聚富康电子有限公司	外贸业务员
深圳市嘉泰奇科技有限公司	外贸业务员
深圳市新利浦科技材料有限公司	盐田外贸业务员
深圳天缘医药科技有限公司	外贸助理/跟单（西乡地铁口+五险一金+奖金）
深圳海博欧科技有限公司	外贸客服(6-8K,年终双薪）
深圳市佳禾进出口有限公司	B2B 外贸业务员
深圳市迪美照明有限公司	LED外贸业务员
深圳美特联合国际物流有限公司	外贸业务助理/五险一金/高薪
深圳市倍瑞德科技有限公司	外贸业务员
深圳市达恩斯光电科技有限公司	外贸业务助理
深圳市立伟成电子科技有限公司	外贸精英（华强北地铁口）
深圳市成熙实业科技有限公司	模具外贸主管+底薪高+提成高
深圳市乙辰科技股份有限公司	外贸业务员
深圳市美莱福科技有限公司	外贸经理
深圳市康胜新能源产品有限公司	外贸业务员
深圳市亘强科技有限公司	外贸业务员 应届生 包住宿
深圳市众信电子有限公司	外贸跟单/应届生/b2b（双休 有培训）
深圳市泰达亨科技有限公司	高薪诚聘eBay销售专员/外贸业务员/eBay运营/B2C运营
深圳市一粒彩科技有限公司	外贸业务精英
深圳宇盛航电子有限公司	阿里巴巴国际站外贸经理
深圳市世纪欣阳科技有限公司	外贸业务员
深圳辰生实业有限公司	外贸销售
深圳市蓝德欧机电有限公司	海外外贸业务员
深圳市励仕照明有限公司	外贸业务员 外贸销售
深圳市晟雅贸易有限公司	外贸业务助理
深圳合新国际物流有限公司	外贸主管
深圳市橙视科技发展有限公司	外贸业务员(应届生）
深圳中润光电技术股份有限公司	外贸业务员
深圳市美创达诚安检设备有限公司	外贸经理
深圳市佳日丰泰电子科技有限公司	外贸/外贸实***吃包住
科罗普泰克（深圳）技术有限公司	外贸跟单员
深圳市悦宝科技有限公司	外贸销售亚马逊运营（应届生皆可）
深圳市威晟光电技术有限公司	外贸主管/外贸销售经理
深圳市创深源科技有限公司	外贸客服
深圳市心之力照明有限公司	外贸跟单员
深圳博英特科技有限公司	外贸业务员
深圳市华森普特科技有限公司	外贸业务员+双休+五险一金
深圳市立思光电科技有限公司	急聘外贸专员外贸主管外贸业务员
深圳市清泓玩具有限公司	龙岗南联-招外贸业务员
深圳市睿世科技有限公司	外贸专员/助理
深圳市缔梦圆科技有限公司	外贸业务员B2C
深圳市大达企业咨询有限公司	外贸业务员（周末双休，可提供住宿）
深圳沃福乐科技有限公司	外贸业务员 提成毛利：20-45个点
深圳市稳利科技有限公司	外贸业务员
深圳市贝利思网络科技有限公司	外贸业务员
深圳市广之超货架实业发展有限公司...	外贸专员
深圳市大洋物流有限公司	外贸会计
深圳金月亮商贸有限公司	外贸跟单（急招）
深圳惠格浩电子有限公司	外贸业务员
惠州长城塑胶工模有限公司	外贸跟单员
深圳市创诚科电子有限公司	外贸业务员/应届毕业生（包住）
深圳市亿伟思特电子有限公司	外贸业务员
深圳市润达同创科技发展有限公司	外贸业务助理（欢迎优秀应届毕业生）
深圳市千晟电声科技有限公司	外贸经理
深圳市昂威物流有限公司	外贸专员
深圳市道合顺科技有限公司	海外（外贸）销售
深圳市诚信诺科技有限公司	外贸跟单员
深圳市晶华泰科技有限公司	外贸国际业务员
深圳市力讯特科技有限公司	eBay销售/外贸销售运营（广州招聘）
深圳市秋然科技发展有限公司	外贸业务助理
深圳市快易点速递有限公司	英文客服/外贸跟单（双休，月均5K+）
深圳点尚电子商务有限公司	网络采购 外贸采购 采购专员
深圳市康凯斯信息技术有限公司	外贸销售
深圳市益心达医学新技术有限公司	外贸业务员
深圳市睿禾科技有限公司	外贸助理/外贸跟单
深圳科思通信息科技有限公司	高薪诚聘 外贸客服 英语在线客服
深圳市创拓电子商务有限公司	亚马逊销/售助理/亚马逊运营助理/应届/外贸助理
深圳市九摩科技有限公司	外贸业务员包住
深圳艾斯柯奥科技有限公司	海外销售经理 外贸业务经理  海外销售总监  高薪
深圳市蓝途新能源电动车有限公司	外贸业务员
深圳品质人生科技有限公司	消费电子外贸业务员
深圳市思博威激光科技有限公司	外贸销售
深圳市飞鹤电子有限公司	外贸跟单员
东莞市明华兴包装有限公司	外贸业务员
深圳市格维电子科技有限公司	外贸跟单/跟单员/业务跟单助理
深圳市高微科电子有限公司	外贸商务助理
深圳市兴达尔科技有限公司	高薪外贸业务员
深圳市舒马特科技有限公司	外贸单证员
深圳联合兴华科技有限公司	外贸SEO推广专员 / SEO优化专员
深圳市博锐纵横科技有限公司	外贸业务员
深圳市聚德鑫信息技术有限公司	外贸经理
深圳前海东方旭�N供应链有限公司	外贸跟单
深圳市博为凯科技有限公司	外贸业务员
深圳市欧尼克五金塑胶制品有限公司...	外贸/贸易主管(年薪12万以上)
深圳市臻鑫数码科技有限公司	外贸销售经理
深圳市三原和电子科技有限公司	外贸主管
优仕伯科技（香港）有限公司	外贸助理
深圳市伟成旺纸品包装有限公司	外贸业务员/礼品包装/宝安西乡
深圳市龙瑞祥贸易有限公司	外贸业务员
深圳众享自动化有限公司	外贸业务员ebay/Amazon（月薪过万、福永地铁口）
深圳市爱的声音响科技有限公司	外贸业务员
深圳市永利兴印刷有限公司	外贸/外贸业务员/外贸销售
深圳市魔宴科技发展有限公司	外贸业务员/展会销售(五和地铁站）
深圳市吉邦科技有限公司	急聘   外贸业务员（月薪6k-1w+包住+年终奖）
深圳市英威腾电源有限公司	外贸经理
深圳市龙星杰电子科技有限公司	外贸业务员 内贸销售 内贸业务员 1688 环球
深圳市奋威科技有限公司	外贸业务员
深圳达维多科技有限公司	B2B 外贸业务员（应届生+近地铁+双休）
深圳力韬胜科技有限公司	外贸精英
深圳弗犹彻电子有限公司	阿里巴巴外贸运营
深圳市科讯实业有限公司	外贸销售
深圳爱拓科技有限公司	机械外贸业务员
慧天科技有限公司	德国外贸经理
深圳市力博得研发中心	外贸经理
深圳市浩瀚卓越科技有限公司	外贸主管
深圳市汉科电子股份有限公司	外贸业务员（耳机）
优康休闲设备（深圳）有限公司	外贸经理
深圳市臻成尚品电子科技有限公司	外贸专员
深圳市萨拉摩尔电子商务有限公司	B2C外贸/速卖通/ebay
深圳索斯特照明有限公司	外贸业务员
深圳市吉迩科技有限公司	高级外贸业务员
深圳市愚公营销策划有限公司	外贸销售专员/b2c销售
奇诺光瑞电子（深圳）有限公司	外贸业务员
深圳市惠邦科技有限公司	Amazon产品美工/ 外贸美工/ 产品拍摄 / 电商美工
深圳市华夏光彩股份有限公司	外贸业务员（LED显示屏）
深圳市品诚伟业科技有限公司	外贸业务员/销售代表
深圳市金大鹏科技有限公司	外贸业务员
深圳市旺特福科技有限公司	B2B外贸业务员
深圳市新峰龙工业有限公司	外贸业务员/外贸销售
深圳艾利克斯通讯有限公司	外贸业务员
深圳市优磁管理技术有限公司	外贸业务助理/外贸业务员
深圳市皇马电器有限公司	外贸区域经理
深圳市龙岗区龙岗华翔机械设备厂	外贸业务员（外贸精英+包吃住）
深圳市联尔科技有限公司	外贸跟单
六洲达国际贸易有限公司	敦煌外贸业务员
深圳西可实业有限公司	外贸业务员
深圳市日丽丰科技有限公司	外贸业务员
深圳市艾斯摩迪斯科技有限公司	外贸业务员（东莞）
宁波中茂网络科技有限公司深圳分公...	B2B外贸业务经理
深圳市联派源科技有限公司	阿里巴巴外贸专员
深圳市杰力科科技有限公司	外贸业务员
深圳市康瑞现代电子有限公司	外贸业务员（塑胶模具10K+
深圳捷渡科技有限公司	外贸助理  应届生5-8
深圳市长恒饰品包装贸易有限公司	外贸业务员
脉众通讯科技有限公司	外贸物流专员
深圳市艾特酷网络科技有限公司	外贸销售
深圳市名禧服装有限公司	服装外贸业务跟单
深圳市妆主实业有限公司	美妆外贸业务员/宝安西乡
深圳塑商宝科技有限公司	外贸销售代表
深圳市中软深科技有限公司	招纳 外贸业务员,外贸精英
深圳红点视效技术有限公司	外贸业务员（欢迎应届毕业生）
深圳乐谱照明科技有限公司	LED外贸业务员
深圳市云熙智能有限公司	急聘电子烟（CBD方向）外贸经理
深圳市德宝智能科技有限公司	外贸专员（可接受应届毕业生）
上海凡卓通讯科技有限公司	外贸业务员
深圳华一创想科技有限公司	外贸销售经理
深圳市新亚芯实业有限公司	诚聘外贸业务员
深圳市乔纳斯电子科技有限公司	外贸业务员
深圳市欣万旗科技有限公司	外贸经理
深圳市爱卓依科技有限公司	外贸专员/高级外贸业务员
深圳市易甲文技术有限公司	外贸业务员
深圳茂硕电子科技有限公司	外贸业务员
深圳市通银海精密电子有限公司	外贸业务员
深圳市康义康科技有限公司	外贸美工设计
深圳小阳科技有限公司	外贸客服专员
深圳市绿元科技有限公司	精英外贸业务员
深圳市聚炫光电照明有限公司	外贸业务员（外贸专员）
深圳市出众数字技术有限公司	外贸专员
深圳市亦青藤电子科技有限公司	外贸业务员
深圳快捷达贸易有限公司	俄罗斯语外贸销售业务员
深圳市福佳电器有限公司	外贸助理/业务跟单
深圳市海天恒和科技有限公司	亚马逊销售  Amazon外贸专员 日语翻译
深圳市沃尔星科技有限公司	亚马逊 英语 外贸
深圳玖灵乐可科技有限公司	外贸业务员/速卖通销售/速卖通运营（地铁站附近急招）
深圳市中瑞科电子有限公司	外贸销售
深圳市高易电子有限公司	外贸业务跟单/业务员（应届生）
深圳市联昶电子有限公司	外贸业务员
深圳市瑞丰光电子股份有限公司	外贸销售工程师（英语+西语）
深圳市索美奇文具有限公司	外贸运营
深圳市万业隆太阳能科技有限公司	外贸业务助理
深圳市比赛得科技有限公司	外贸业务员（包住）
深圳市微改科技有限公司	亚马逊运营销售Amazon外贸业务
深圳哈卡科技有限公司	外贸业务员
深圳洛普智能科技有限公司	高薪外贸业务员
深圳市灰度科技有限公司	外贸业务员
深圳市可大体育器材有限公司	外贸业务员
升辉工艺（深圳）有限公司	外贸跟单员
利亚德智慧显示（深圳）有限公司	外贸业务助理/跟单
深圳市沃行科技有限公司	外贸跟单文员
深圳乘光网络通信有限公司	外贸业务员
华视伟业（深圳）科技有限公司	外贸业务经理
深圳市顺讯电子有限公司	外贸业务员 5.5-20K  包吃住
深圳市太格王科技有限公司	急招 外贸业务助理
深圳市美康德科技有限公司	阿里巴巴外贸销售（双休+吉祥地铁站）
深圳市斯博特斯科技有限公司	长沙外贸业务员五险
深圳市朗胜光科技有限公司	外贸专员
深圳市华唐心悦商贸有限公司	外贸专员/速卖通（急聘 包住宿）
环胜电子（深圳）有限公司	外贸跟单专员
深圳市汉力特通信技术有限公司	外贸业务员
深圳爱彼电路股份有限公司	PCB外贸经理
深圳市英普泰科技有限公司	B2B外贸销售
深圳市崧盛电子股份有限公司	俄语销售 /外贸业务
深圳市英利泰电子有限公司	外贸专员
深圳市创蓝智汇科技有限公司	应届毕业生实习生跨境外贸电子商务专员
深圳市秀妆化妆用具有限公司	外贸业务员
凯灿贸易（深圳）有限公司	五险一金招外贸跟单
深圳市瑞梓光电科技有限公司	外贸专员
深圳市极速科技有限公司	外贸业务员
深圳亚圻表业有限公司	外贸/贸易专员/助理
深圳市凯林克进出口有限公司	陶瓷外贸业务员
广东高普达集团股份有限公司	外贸跟单
深圳塔赫信息咨询有限公司 Shenzh...	外贸采购跟单Merchandiser--杂货
深圳市科尔创科技有限公司	外贸业务员（周末双休 地铁口）
深圳市华电照明有限公司	外贸业务员+高提成+年终奖
深圳市科顺达科技有限公司	外贸专员（应届生亦可）
深圳市鑫豪信电子科技有限公司	外贸主管/外贸经理
香港赣辉集团有限公司	应届毕业生/外贸业务
凌视科技（深圳）有限公司	外贸业务员/外贸助理(包住)
深圳市奈哲尔科技有限公司	外贸业务员（高提成+绩效奖金+底薪）
深圳市大汉朝科技发展有限公司	应届生/商务助理/跨境/外贸业务
深圳市赛通实业有限公司	外贸业务 B2B外贸销售
深圳市乐职科技有限公司	外贸业务员
深圳市守正航空工业有限公司	外贸业务员
深圳市恒耀光电科技有限公司	外贸业务员
深圳市华源达科技有限公司	外贸业务助理
深圳市叁陆伍物联科技有限公司	外贸跟单文员/跟单员
深圳市明晨鑫科技发展有限公司	外贸销售跟单员 国际业务助理
深圳市英博伟业科技有限公司	外贸采购员
深圳智贸家居有限公司	Sourcing/Merchandiser 采购/外贸跟单
深圳晨芯时代科技有限公司	外贸销售员
深圳可视科技有限公司	外贸业务员
深圳市杰威比科技有限公司	外贸业务
深圳格林韵达科技有限公司	外贸业务员
深圳市普尔印刷制品有限公司	外贸业务员
深圳市伊诺时代科技有限公司	外贸业务员
郴州市晶讯光电有限公司	外贸跟单员
深圳市凯斯希尔科技有限公司	外贸专员
深圳市蓝畅科技有限公司	外贸业务员
东莞市亿伟塑胶有限公司	外贸业务员
香港路华特亚洲有限公司深圳代表处...	外贸专员
山东精工电子科技有限公司深圳分公...	锂电池外贸业务员、外贸销售代表
深圳市赫迪化妆用具有限公司	外贸跟单员
深圳市爱庞德新能源科技有限公司	外贸专员（直接海外拜访）
深圳市联合智能卡有限公司	外贸业务拓展助理，外贸文案
深圳市夏妹跨境电商有限公司	法语、西语外贸专员/电商运营
深圳市泰得模具科技有限公司	外贸主管
深圳市优吉福科技有限公司	外贸跟单员
深圳市精秒科技有限公司	外贸助理
深圳市铭新晨贸易有限公司	实习生/外贸客服/跟单/英语四级
广东汇乐玩具实业有限公司	外贸经理
深圳市诺比光电有限公司	外贸业务员
遨蓝实业（深圳）有限公司	（急聘）外贸业务员/外贸专员
深圳市德沃斯科技有限公司	贸易/外贸经理/主管/外贸业务
联星体育用品（深圳）有限公司	外贸业务跟单
深圳勤易泰科技有限公司	高新诚聘外贸业务员
倍通电子（香港）有限公司 HITEK ...	外贸专员
深圳市中立创轴承有限公司	外贸跟单员 英文跟单员
深圳市贝特电子有限公司	外贸经理
深圳邦基线路板有限公司	外贸销售
深圳吉车达科技有限公司	外贸业务员
深圳市宏元化工新材料科技有限公司...	外贸业务员
深圳市艾尼斯电子科技有限公司	外贸经理
深圳市杰普特光电股份有限公司	外贸跟单
深圳市赢电科技有限公司	外贸助理
深圳市支氏环保科技有限公司	外贸跟单员
深圳维纳斯科技有限公司	电子烟外贸业务员+高提成
深圳市金利昂科技有限公司	跨境电商 外贸销售
深圳市瑞缇纳电子商务有限公司	敦煌网外贸业务员（高底薪高提成五险一金）
深圳市艾特铭客科技有限公司	外贸业务员
深圳市杜科实业有限公司	外贸业务员/沙井
崇达技术股份有限公司	外贸跟单
深圳市艾蒂威肯科技有限公司	电子烟外贸业务员
深圳市纬信科技有限公司	外贸业务员（应届毕业生）
深圳市奥利弗科技有限公司	外贸经理
深圳市瀚泽华电子商务有限公司	速卖通外贸业务员（出单快 高提成 员工公寓）
深圳市冠泰橡胶制品有限公司	外贸业务助理
深圳市明皓义齿有限公司	外贸专员
深圳奥伟仕科技有限公司	外贸销售
深圳市硅宇电子有限公司	电子外贸业务员
深圳市露西原创玩具有限公司	外贸业务
深圳市中深爱的寝具科技有限公司	外贸业务员
深圳市艾蔻电子科技有限公司	外贸专员
深圳市新路程人力资源有限公司	外贸经理 月薪15K 提成
七彩人生集团有限公司	外贸业务员
江苏春兰进出口有限公司	外贸经理
深圳市三联致合科技有限公司	蓝牙耳机外贸业务员
佛山市光棱科技有限公司	外贸业务员
深圳市盈旺德电子有限公司	急聘 外贸跟单/外贸助理
大为智造（深圳）科技有限公司	外贸销售
深圳海滨制药有限公司	外贸单证员
深圳市丽台电子有限公司	外贸助理
广东双鹰玩具实业有限公司	外贸业务员（双休）
深圳市英桥龙科技有限公司	外贸部经理
深圳新瑞思科技有限公司	外贸业务员
冠佳国际电子有限公司	外贸采购员
深圳市爱比瑞塑胶模具有限公司	外贸跟单主管（月薪10K以上+出国旅游）
深圳市三特科技有限公司	外贸业务员
深圳市旭�N生物科技有限公司	电子烟烟油外贸精英
深圳市信威电子有限公司	外贸跟单
深圳市芯品质科技有限公司	外贸房车锂电池业务合伙人
香港力同国际控股（集团）有限公司...	外贸业务员(佛山)
深圳飞道科技发展有限公司	海外/外贸推广助理
东莞市塑航精密组件有限公司	外贸业务员应届毕业生
深圳市捷希科技有限公司	外贸跟单员
深圳市斯达斯科技有限公司	外贸跟单员
深圳市锐吉电子科技有限公司	国际销售/外贸业务员
深圳市圣宏亮科技有限公司	外贸业务员（包吃住）
深圳致君科技有限公司	外贸业务跟单/助理
深圳市壹易电子商务有限公司	外贸业务员/亚马逊英语运营
深圳雷亚商务有限公司	外贸业务员
深圳讯道实业股份有限公司	外贸业务员
深圳市伊尚智能运动有限公司	外贸跟单
深圳市美碧科科技有限公司	外贸业务员+双休
深圳市颍创科技有限公司	阿里巴巴国际外贸业务员
深圳市科乐科技有限公司	外贸/外贸业务员（底薪5K起+高提成）
深圳钜彩照明科技有限公司	LED外贸销售
深圳市志胜威电子设备有限公司	外贸业务员
深圳诺而为尔科技有限公司	外贸业务 （急聘+高薪）
深圳市爱谱欧迪科技有限责任公司	外贸业务/销售
深圳市耐实科技有限公司	亚马逊运营专员/外贸专员
深圳市创伦纺织有限公司	外贸业务员
深圳市鸿基电子科技有限公司	外贸业务员（高底薪+高提成）
深圳市三力电源科技有限公司	外贸专员
深圳迈拓数码科技有限公司	外贸专员
深圳市索爱无线互联科技有限公司	外贸专员
深圳市恒星智科技有限公司	外贸业务人员 国际贸易 外贸专员
深圳市尚为酒具有限公司	外贸业务员/贸易专员  B2B 工贸一体
深圳市源微创新实业有限公司	外贸业务员
深圳市华芯技研科技有限公司	外贸业务员
深圳市澳拓普电子有限公司	外贸业务员
中南国际人力资源（深圳）有限公司...	外贸单证员
深圳盟云全息文化有限公司	外贸专员
菁一实业（深圳）有限公司	外贸业务员
深圳市芯晶彩科技有限公司	外贸业务员
深圳市庆丰收科技有限公司	Newegg LAZADA坂田商务外贸业务精品销售英文专业
深圳市兴汇禾数码科技有限公司	外贸业务员（可合作）
深圳市极兵城电子商务有限公司	外贸 英文专业 英语助理
深圳科宏健科技有限公司	外贸业务员（西班牙语）
深圳市汽车人科技有限公司	外贸业务员
深圳市帝拓电子有限公司	外贸业务员+高提成+大小周+年终奖+包吃住+急聘
深圳市奈沃斯科技有限公司	外贸专员/业务（高底薪+包住）
深圳曦泰国际商贸有限公司	外贸业务助理
深圳市世旺凯电子有限公司	外贸跟单员（双休）
深圳市侃佩电子有限公司	外贸业务员
深圳市云羿贸易科技有限公司	法语/德语/日语外贸专员
深圳市兆威机电股份有限公司	外贸业务经理
深圳市誉勤电子有限公司	外贸业务员
深圳市海柏恩科技有限公司	外贸跟单（日语）
惠州市迈锐光电有限公司	外贸助理
东莞欧森隆科技发展有限公司	外贸助理
爱视奇科技（深圳）有限公司	外贸业务员（应届毕业生）
深圳市易博利科技有限公司	外贸助理
深圳市卡利欧实业有限公司	外贸业务助理
深圳市创想三维科技有限公司	外贸组长
深圳市迈锐光电有限公司	外贸业务员
深圳市优优美科技有限公司	外贸业务-赣州
深圳市美果源科技有限公司	外贸采购员
深圳市力源工业装备有限公司	外贸业务员
深圳市华鑫伟天光电有限公司	外贸经理/外贸主管
深圳市亿典华科技有限公司	外贸业务/外贸专员/外贸经理（急聘包住）
深圳市明兴光电子科技有限公司	外贸业务员
上海大山合菌物科技股份有限公司	外贸/贸易经理
深圳市佳维视电子科技有限公司	外贸推广专员
深圳市金威澎电子有限公司	外贸跟单员
深圳市鼎品电器有限公司	外贸跟单员
深圳市友立联科技有限公司	外贸业务员
深圳市友谊达数码有限公司	外贸业务员（高提成  年终奖）
深圳市思科耐实业有限公司	外贸业务员
深圳市高斯贝尔家居智能电子有限公...	外贸业务助理
深圳市瑞利晶彩显示技术有限公司	外贸业务员
深圳市飞帆泰科技有限公司	外贸业务员
深圳瑞福来智能科技股份有限公司	外贸业务助理
深圳市洋沃电子有限公司	外贸/贸易主管
深圳祥瑞达贸易有限公司	急聘外贸专员外贸助理外贸跟单
深圳市百时彩织造有限公司	外贸业务员
深圳市千艺科技开发有限公司	外贸业务员
深圳市智宇精密五金有限公司	外贸业务员
深圳市泰明辉实业有限公司	外贸跟单员
深圳市华宇成通讯有限公司	电子烟外贸员
深圳市莎朗科技股份有限公司	外贸业务员
联扬塑胶（深圳）有限公司	外贸业务员
深圳市讯鹏科技有限公司	外贸业务员
江西京九电源科技有限公司	工业电池外贸主管
深圳市佳胜实业有限公司	外贸业务员高薪8K起
深圳深爱半导体股份有限公司	外贸销售经理
深圳市很扎实科技有限公司	亚马逊运营/外贸专员
深圳雅各之星实业有限公司	外贸专员/助理
林林雷恩个人护理（深圳）有限公司...	华强北诚聘alibaba阿里巴巴外贸业务8K-1w英文好有经验
深圳市顾德语言服务有限公司	外贸助理
深圳市龙迪电子有限公司	外贸业务员
深圳金诚卫浴有限公司	外贸业务员 五天半制 包吃住
深圳市特比通光电有限公司	外贸业务员（底薪5k+++双休+五险+旅游+年末双薪）
讯达康通讯设备（惠州）有限公司	外贸业务员（双休+国外上班+年终奖）
深圳市祥天跨境电子商务有限公司	LED外贸销售经理
深圳市欧莱亚照明有限公司	外贸业务员
SUMAC TECHNOLOGIES ENTERPRISE I...	外贸跟单员Merchandiser（深圳和东莞）
深圳市格凯科技有限公司	外贸业务
深圳市艾格林电子有限公司	外贸专员/ Sales（电子元件）
深圳市盈瑞光电有限公司	外贸业务员
宁波天下汽配有限公司	外贸业务员（跟单业务员）
深圳市航宇国际物流有限公司	外贸海运操作
深圳米乔科技有限公司	外贸业务员
深圳市宝菱实业有限公司	亚马逊 外贸员 实习生
深圳市鑫彩翼科技有限公司	急聘 外贸员
深圳创纪城网络科技有限公司	外贸产品开发
深圳市中电开拓实业有限公司	外贸/贸易专员/助理
深圳波斯通物流有限公司	外贸跟单（宝安福永）
深圳市觅客科技有限公司	Amazon销售/亚马逊销售/外贸业务员
深圳市品触光电科技有限公司	外贸经理
深圳市赛其创新科技有限公司	急招外贸业务员
深圳市飞�N翼电子科技有限公司	外贸助理
深圳市雷萨电子有限公司	外贸运营英语6级
鸿博盛世（深圳）贸易有限公司	外贸业务员
深圳市兴丰塑胶有限公司	外贸业务员
深圳艾迪森光电有限公司	外贸业务员（应届生）宝安石岩+包住宿
广东翔龙新能源有限公司	外贸业务员
深圳市哥悟电子科技有限公司	外贸跟单/贸易跟单/跟单员
深圳云联金通科技有限公司	外贸运营   电商主管
深圳德兰本福电器有限公司	外贸业务(底薪4-8K)
深圳市锦泰包装制品有限公司	外贸组长（双休+高薪）
湖南贵德科技有限公司深圳市分公司...	外贸销售
深圳市彼岸风电子科技有限公司	电商助理/外贸助理（应届毕业生）
深圳市海盈威科技有限公司	外贸跟单员
新昌丝绸服装（深圳）有限公司	服装外贸跟单员
深圳市鼎盛皇科技发展有限公司	外贸业务员
深圳市华本文具有限公司	外贸销售代表
深圳市浦洛电子科技有限公司	外贸销售/外贸专员/外贸业务员
重庆尚上服饰有限公司	外贸业务员
深圳市科音美科技有限公司	蓝牙耳机外贸业务员
深圳市汉宜家居用品有限公司	外贸业务员
深圳市精禾化工有限公司	外贸业务员 (面议)
深圳市施恒科技有限公司	亚马逊运营专员/亚马逊销售/外贸业务员
深圳市天地人民科技有限公司	外贸跟单员
深圳市巨豪自动化设备有限公司	外贸业务员
深圳市伟鹏世纪科技有限公司	外贸业务员
深圳市明达纺织有限公司	外贸跟单
深圳市承拓电子有限公司	外贸业务员/外贸销售员/外贸跟单
深圳市景欣泰家居用品有限公司	外贸业务员
深圳市竹桥数码科技有限公司	外贸文员
深圳市优创亿科技有限公司	外贸业务员
深圳市拓易跨境电商有限公司	外贸业务员
深圳市前海雅酷科技有限公司	应届毕业生 外贸跨境电商助理
深圳市富瑞灵珂实业有限公司	外贸业务员
深圳深海创新技术有限公司	外贸业务员 亚马逊销售助理
深圳市金豪泰科技有限公司	外�Q�I��
深圳市泰亿格贸易有限公司	外贸业务员
深圳伐客贸易有限公司	急聘 外贸跨境专员（欢迎应届毕业生）
亚杰进出口贸易（深圳）有限公司	外贸业务助理
深圳市优鼎昊电子有限公司	外贸业务员 外贸跟单文员
深圳市美深威科技有限公司	外贸业务
深圳市昱易源科技有限公司	外贸业务员
深圳市宏济医疗技术开发有限公司	外贸业务助理
深圳市史丹福袋业有限公司	外贸业务跟单员
长沙市言必信翻译有限公司	外贸业务员5000+提成
深圳市易控迪智能家居科技有限公司...	外贸业务员
深圳市美新特智能装备有限公司	外贸推广销售专员
深圳喜瑞鹿玩具有限公司	外贸业务员/外贸专员
深圳市瑞吉思科技有限公司	外贸专员
深圳市兴华颜料色母有限公司	外贸销售
深圳全顺科贸易有限公司	外贸打包员
拓瑞仕信息咨询（深圳）有限公司	外贸跟单员
深圳东盈富通电子有限公司	外贸销售（LCD/液晶屏）
深圳德克密封技术有限公司	外贸业务员
深圳市全雅贸易有限公司	外贸跟单
深圳市爱立康医疗股份有限公司	外贸业务（医疗器械类）
深圳市东方艺辰工业设计有限公司	外贸销售
深圳市优斯凯科技有限公司	外贸业务员
升励五金（深圳）有限公司	外贸跟单员
深圳市华瑞星辰科技有限公司	外贸业务员
深圳市展鹏翔实业有限公司	外贸业务员
深圳市优迪斯电子商务有限公司	外贸销售
深圳市森动律科技有限公司	外贸销售-蓝牙耳机
深圳市麦逗科技有限公司	电子产品外贸业务主管
深圳市特加特科技有限公司	阿里国际站/速卖通运营/外贸运营
深圳市广仁德科技有限公司	外贸储备干部
深圳市阿奇柏德科技有限公司	外贸业务员
深圳市创科达精密机电有限公司	外贸业务员/专员
深圳市东佳实业有限公司	外贸业务员
深圳市华亿昌化工颜料有限公司	高薪诚聘外贸业务员
深圳市互联恒通贸易有限公司	急聘外贸仓库打包员
深圳市恒创展示制品有限公司	外贸业务(高薪包吃住）
深圳市安宇客科技有限公司	Amazon亚马逊运营/外贸
深圳市时影科技有限公司	外贸业务助理
深圳市深波电子有限公司	外贸销售
深圳金碧龙进出口有限公司	外贸专员
中电安全智能科技（深圳）有限公司...	外贸经理
美易利箱包（上海）有限公司深圳分...	外贸采购助理
峰高实业（深圳）有限公司	外贸跟单员
深圳市飞通宽带技术有限公司	外贸销售
东莞市威狮特企业管理咨询有限公司...	Walmart Merchandiser- 沃尔玛外贸跟单
深圳艾史比特电机有限公司	外贸采购员
中天世纪实业（深圳）有限公司	外贸跟单员
鲸座科技(深圳)有限公司	行政人事主管
深圳联信浩科技有限公司	美工
深圳市和棋贸易有限公司	亚马逊美国站运营（精品）
深圳学海舟科技有限公司	欧美亚马逊精品（地铁口）
深圳市景荣国际货运代理有限公司	海外销售助理
深圳市鑫英利科技有限公司	财务助理/出纳
深圳市拓普森科技有限公司	亚马逊销售代表（高薪10K 以上可包住宿)
前海众拓跨境电商（深圳）有限公司...	美工/电商美工
深圳市华士科电子有限公司	急聘QC 质检员
深圳市日月泽科技有限公司	英国站高级销售
深圳市卡迪娅家居饰品有限公司	国际销售经理
深圳市宝扬科技有限公司	速卖通运营
深圳古瑞瓦特能源科技有限公司	国际销售
深圳市骏进科技开发有限公司	外贸业务员/外贸销售/海外销售/外贸跟单
深圳市长进国际物流有限公司	海外业务员（熟手）
特美（上海）国际货运代理有限公司...	海运出口操作员
深圳市掘易尔科技有限公司	亚马逊运营经理
深圳市三宝创新智能有限公司	海外销售经理（机器人）
深圳市欧倍德电子有限公司	亚马逊销售Amazon运营 高薪急招
贝法易集团	物流销售代表
深圳市吉利通电子有限公司	海外销售经理/业务员
深圳市长帆国际物流股份有限公司	海外业务专员（可提供住宿）
汇利达国际货运代理（广州）有限公...	空运操作
深圳百福淇进出口有限公司	制衣英文跟单
深圳市南太国际货运代理有限公司	销售代表（海运/空运/进口/海外）
深圳市普森斯科技有限公司	SEO/SEM
深圳市迈科捷科技有限公司	LAZADA SHOPEE 运营
深圳市维卡仕科技有限公司	急招亚马逊运营（底薪+高提成）
深圳多宝利科技有限公司	亚马逊销售助理/客服（招应届毕业生）
深圳市同创远锋贸易有限公司	周末双休 产品开发专员
壹派信息科技（深圳）有限公司	海运操作
深圳市途腾网络科技有限公司	ERP销售合伙人
深圳乔微医疗服务有限公司	平面设计师/美工
深圳市泽源国际货运代理有限公司	海运客服
中戈科技有限公司	销售业务员
深圳市金畅进出口有限公司	日语电商运营5k-8k以上
深圳市金宏源电子技术有限公司	速卖通aliexpress 运营销售专员
深圳潮影艺术文化有限公司	Amazon亚马逊运营
增你强（深圳）科技有限公司	急招电子行业采购助理
正念生命科学研究（深圳）有限公司...	亚马逊amazon运营专员
深圳力芯联合科技有限公司	亚马逊运营员
联禾纺织（深圳）有限公司	跟单文员
深圳市鑫普泰科技有限公司	高底薪 稳定提成 Amazon/亚马逊销售员
深圳市尊景网络科技有限公司	亚马逊运营/销售
慕佰仕物流（上海）有限公司	销售业务员-深圳
深圳市鑫鲲鹏国际物流有限公司	海外客服
深圳市大广发物流有限公司	项目跟单专员（宝安包住）
深圳市智维知物流有限公司	海外销售（急招）
深圳恒芸生泰科技有限公司	海外销售经理（3C数码）
深圳市尚美电商物流有限公司	海外销售代表
北美司工业（深圳）有限公司	销售专员/市场经理
深圳市阳者新能源科技有限公司	亚马逊英语销售
深圳市聚旺欣电子科技有限公司	亚马逊运营专员
深圳市丰景晟电子科技有限公司	亚马逊运营专员
深圳市捷华电子商务有限公司	Amazon产品专员/产品开发/品类开发
深圳华唐锐照明电器有限公司	International Sales Representative
深圳康德环宇智能供应链有限公司	（区块链系统）销售经理
深圳市中泰达医疗器械有限公司	行政人事主管
东莞美创商务咨询有限公司	admin specialist 行政专员
深圳市极摩科技有限公司	亚马逊日语销售助理
深圳湾游艇会有限公司	报关员
深圳市惠仁科技有限公司	国际贸易销售